布局	构造	组织	结构	规划
一一	逐一	逐个
一下子	一会儿
一不做，二不休	是可忍，孰不可忍	灭此朝食	破釜沉舟	背城借一	背水一战	义无反顾	勇往直前
一个钱打二十四个结	精打细算	持筹握算	皇天不负有心人	锲而不舍	持之以恒	细水长流	绳锯木断
一举一动	一言一行	所作所为
一举万里	一举千里
一举两得	一石二鸟	一箭双雕	一本万利	事半功倍	渔人之利
一举成名	一鸣惊人	如鱼得水	平步青云	蛟龙得水	青云直上	飞黄腾达	扶摇直上	百尺竿头	一步登天	步步登高	名满天下
一举而竟全功	毕其功于一役	大功告成	半途而废	浅尝辄止	浮光掠影	走马观花	前功尽弃	功亏一篑	功败垂成	付之东流	前功尽灭	壮志未酬	有始无终
一事无成	百无一成	百无所成
一五一十	如数家珍
一人传虚	万人传实
一人得道	鸡犬升天	浓妆艳裹	粉墨登场	袍笏登场	弹冠相庆	拍手称快	普天同庆	额手称庆
一人得道，鸡犬升天	一人飞升，鸡犬升天
一介书生	文人雅士	文章巨公	骚人墨客
一再	几回	再三	几次	频频	堆叠	重叠
一切	十足	实足
一刻千金	一寸光阴一寸金	寸阴可惜	寸阴尺璧	寸阴是惜
一劳永逸	一了百了	一了百当	一笔勾销	功德圆满	寿终正寝
一去不返	断线风筝
一双两好	才子佳人	郎才女貌	金童玉女
一口咬定	矢口不移
一叶知秋	尝鼎一	尝鼎一脔	见微知着	落叶知秋	月晕而风	础润而雨
一叶落而知天下秋	落叶知秋
一叶障目，不见森林	一叶障目，不见泰山
一同	一起	一路
一命呜呼	一命归天	命赴黄泉	玉陨香消	葬身鱼腹	香消玉殒	呜乎哀哉	寿终正寝	与世长辞	呜呼哀哉	一卧不起	一病不起	一命归西	一命归阴	一暝不视	葬玉埋香	长眠不起
一哄而散	不欢而散	作鸟兽散	妻离子散	家破人亡	离乡背井	扬长而去	漂洋过海	跋山涉水	远涉重洋	远走高飞	逃之夭夭	金蝉脱壳	长途跋涉	拂袖而去
一哄而起	一应而起
一塌糊涂	乌烟瘴气
一壁	一面
一声不吭	闷葫芦
一声不响	一言不发	不言不语
一夫当关	丸泥封关
一夫当关，万夫莫开	一夫当关，万夫莫摧
一失一得	得失相当	楚弓楚得	得不偿失	贪小失大	进寸退尺	因小失大	寸进尺退	惜指失掌	以珠弹雀
一女不事二夫	从一而终
一字一句	一字一板
一字不易	一字未改	不易一字
一家之言	一家之辞
一尘不染	一干二净	六根清净	纤尘不染
一岁三迁	不次之位	不次之迁	破格提拔	连升三级
一差二错	阴错阳差
一帆风顺	一路平安	一路顺风	无往不利	天从人愿	径情直行	径情直遂	直情径行
一张一弛	以逸待劳
一往直前	百折不回	勇往直前	高歌猛进	坚定不移	始终不渝	不屈不挠	再接再厉	坚韧不拔	百折不挠	绝不屈服	坚强不屈	坚忍不拔	视死如归
地久天长	海誓山盟
一律	一概	划一
一心	同心	专心
一成不变	日月经天	江河行地	原封不动	一定不易	一定不移
一技之长	一无所长	才有所长
一拥而上	蜂拥而至	蜂拥而上	蜂拥而来
一文不值	一钱不值
一无可取	一无是处	百无一是	百无一用
一无所有	赤贫如洗	一介不取	两手空空	两袖清风	赤手空拳	南箕北斗	有名无实
一无所求	别无所求
一无所知	一概不知	一窍不通	目不识丁
一无长物	别无长物
一日千里	日新月异	沧桑陵谷	沧海桑田	渤澥桑田	白云苍狗	突飞猛进	天翻地覆	翻天覆地	覆地翻天	与日俱增	有加无已	日积月累	有增无已	穷年累月	如日方升	旭日东升	生机勃勃	蒸蒸日上	一日万里	进步神速
一时哄动	哄传一时
一是一，二是二	老老实实
一望可知	蛛丝马迹
一板一眼	一板三眼	头头是道	有声有色1	有条有理	有板有眼	条理分明
一枝独秀	桂林一枝
一槌定音	一锤定音
一步一摇	寸步难行	步履维艰	步履蹒跚	进退维谷	左右两难	左右为难	欲罢不能	进退两难	进退为难	骑虎难下	不能自休
一气呵成	文不加点	乘热打铁	趁热打铁	连成一气	事不宜迟	兵贵神速	速战速决	不可或缓	时不可失	趁水和泥
一泻千里	一落千丈	江河日下	一蹶不振
一浆十饼	小恩小惠	封官许愿	笼络人心	煦煦孑孑
一点不错	分毫不爽	丝毫不差	分毫无爽	一毫不差	不失圭撮	不失毫厘	不差毫厘	毫厘不差
一生	平生	生平	终生	终身	毕生	没世
一男半女	寸男尺女
一盘散沙	人心涣散	七零八落	乌合之众	四分五裂	支离破碎	零七八碎	残缺不全	一鳞半爪	星落云散	片纸只字	东鳞西爪	缺头少尾
一相情愿	两相情愿	一厢情愿	一己之见	如意算盘	协力同心	同心合力	同心并力	两全其美	同心同德	皆大欢喜	齐心协力	一箭双鵰
一矢之地	弹丸之地	方寸之地	立锥之地	一席之地	一隅之地	插针之地	立足之地
一笔勾消	一笔勾销	一笔抹杀	一笔抹煞
一箭上垛	一箭中的
一箭之地	咫尺之隔	近在眼前	朝发夕至	朝发暮至	一水之隔	一衣带水	近在咫尺	近在眉睫	天涯比邻	遥遥在望	鸡犬相闻
一索得男	一索成男
一而再，再而三	三番五次	再三再四	屡次三番	两次三番	几次三番	接连不断	绵亘不绝	绵绵不绝	连绵不断	连绵起伏	无冬无夏	无间冬夏	纷来沓至	连续不断	接二连三	接踵而至	纷至沓来	接踵而来	络绎不绝	一连	延续	连续
一腔热血	满腔热枕	热肠古道
一至于斯	一至于此
一般	个体	个别	一样平常	平凡	日常	普通	通俗
一表人才	一表非凡	仪表堂堂	飒爽英姿	英姿飒爽	生龙活虎	英姿勃勃	龙腾虎跃	龙精虎猛	意气焕发	意气风发	斗志昂扬	生气勃勃	神采飞扬
一见钟情	情投意合	一见倾心	一往情深	一见如故	情意绵绵	情深意重	深情厚意	一拍即合	一面如旧
一视同仁	混为一谈	相提并论	等量齐观	并为一谈	同日而语	不顾一切	不顾安危	不顾死活	置之度外	悍然不顾	顾虑重重	不分皂白	不分青红皂白	不管三七二十一	不问青红皂白	是非不分	混淆黑白	宠辱不惊	束之高阁	置之不理
一触即发	剑拔弩张	箭拔弩张	触机便发
一言九鼎	出言如山	一字千金	惜墨如金	言简意赅	字字珠玑	掷地有声	生花妙笔	一字一珠	一字千钧	一笔不苟	一言为定	坐不垂堂	字字千钧	谨小慎微	郑重其事	金口玉言
一言以蔽之	总而言之	综上所述
一言既出，驷马难追	君子一言，快马一鞭	言而有信	君子一言，驷马难追	言信行果	言出必行	言必信，行必果	信誓旦旦	指天为誓	指天誓日	山盟海誓	金石之盟	口口声声	有口无心	海枯石烂	言不由衷
一言难尽	说来话长
一语中的	寸铁杀人	一语而解	片言立决	豁然开朗
一误再误	将错就错	知错不改	坚不可摧	是非混淆	根深柢固	积重难返	积非成是
一谦自益	满招损，谦受益	益谦亏盈	虚怀若谷	不耻下可	不露锋芒	大巧若拙	大智若愚	不骄不躁	功成不居	戒骄戒躁	不亢不卑	不卑不亢	不矜不伐	谦虚谨慎	不耻下问	深藏若谷
一败如水	一蹶不振	再衰三竭	大势已去	强弩之末	每况愈下	落花流水	傲卒多败	骄兵必败	屁滚尿流	狼奔豕突	名落孙山	望风披靡	溃不成军	日暮途穷
一败涂地	片甲不留	丢盔弃甲	全军覆没	溃退	败退
一走了之	不辞而别	溜之大吉	绝尘而去	逃之夭夭	抛戈弃甲	抱头鼠窜	狼狈而逃	丢盔弃甲	望风破胆	望风而逃	桃之夭夭
一身而二任	身兼数职
一轨同风	车同轨，书同文
一针见血	提纲挈领	纲举目张	一语道破	画龙点睛	以一持万
一钱不受	分文不取
一问一答	有问必答	谆谆教诲
一面之词	一面之辞	偏听偏信
一饭之德	滴水之恩
一马平川	一望无际	一望无边	无边无涯	无边无际	漫无边际
一马当先1	遥遥领先
一马当先2	首当其冲	奋勇争先	奋勇当先
以身作则	现身说法	言传身教	身先士卒
一龙一蛇	或隐或显
丁一卯二	的一确二	丁一确二	丁是丁，卯是卯
丁忧	母丧	父丧	丧父	失怙
七嘴八舌	七言八语	人多口杂	众口纷纭	众说纷纭	人多嘴杂	发言盈庭	畅所欲言	知无不言	各抒己见	人言啧啧	怨声载道	言人人殊	议论纷纷
七步之才	出口成章	下笔成章	锦心绣口	出言成章	文思敏捷
七病八痛	三病两痛	五劳七伤
七通八达	四通八达
万万	切切	千万
万人空巷	万头攒动
万众一心	同心同德	齐心协力	齐心合力	举国同心	众志成城	众擎易举	志同道合	步调一致	博采众长	集思广益	群策群力	广开言路	同心协力	同心戮力	同仇敌忾	群威群胆
万剐千刀	五马分尸	千刀万剐	杀人如麻	嗜血成性	斩尽杀绝	枯本竭源	救死扶伤	治病救人	救急扶伤	吊死问疾
万夫不当	万夫不当之勇
万念俱灰	百念皆灰	万念俱寂	大失所望	灰心丧气	朽木死灰	槁木死灰
万死一生	九死一生	十生九死	死里逃生	虎口余生	死中求生	死里求生	虎口逃生
万水千山	千山万壑	千山万水	万壑千岩	千岩万壑	层峦叠嶂	群山万壑	丛山峻岭	崇山峻岭
万能	全能
万试万灵	功效如神
万马奔腾	热气腾腾	热火朝天	蒸蒸日上	如火如荼	风起云涌	汹涌澎拜	方兴未艾	风起潮涌
丈量	测量仪态万千	仪态万方	倾国倾城	绝色佳人
三五成群	攒三聚五	攒三集五	成群结队
三令五申	再三告诫	下令	号令	命令	敕令	饬令	呼吁	发号	发号令	发号布令	发号施令	颐指气使	千叮万嘱	呐喊
三军	全军
三十而立	当立之年	而立之年	丁壮	壮年	成年
三千珠履	宾客盈庭
三回九曲	三回九转
三头六臂	神通广大	手眼通天
三妻四妾	三宫六院
三姑六婆	三教九流	五行八作	九流三教
三寸不烂之舌	三寸之舌
三平二满	四平八稳
三思而行	深图远虑	深思熟虑	兼权尚计	三思而后行	沉思熟虑	深谋远虑	老谋深算
三更	三鼓	午夜	半夜	子夜
三瓦两巷	三瓦两舍
三生有幸	福星高照	吉星高照	吉祥如意	大吉大利	洪福齐天	福如东海
三百六十行	各行各业
三皇五帝	不祧之宗	不祧之祖	开山祖师	鼻祖	开山始祖	开山老祖	开山鼻祖	始祖
三纸无驴	废话连篇	言之无物	奇文瑰句	空话连篇
三豕涉河	三豕渡河
三足鼎立	相持不下	鼎足而三	鼎足而立	三分鼎足	鼎足之势	分庭抗礼
三跪九叩	打躬作揖	顶礼膜拜	以礼待人	低头哈腰	点头哈腰
三顾茅庐	草庐三顾
上升	回升	增长
上吊	吊颈	悬梁
上圈套	上当	受愚	被骗	受骗
上天	入地
上将	大将
上岸	登岸	登陆
上帝	天主
上弦	下弦
上彀	上网
上无片瓦，下无卓锥	上无片瓦，下无立锥之地
上次	前次
上演	演出	表演	化妆	化装	扮演	扮装	上镜	饰演
上苍	彼苍	苍天	青天
上钩	中计	入彀	入网
上风	下风	优势
下乔入幽	下乔迁谷	弃明从暗
下午	下昼	午后
下战书	挑衅
下学	放学
下层	基层
下属	属下	手下	部下	部属
下手1	动手	出手
下手2	入手	着手
下气怡声	下气怡色
下流	下贱	轻贱
下流至极	卑鄙下作	卑鄙下流	卑鄙无耻	卑鄙龌龊	厚颜无耻	不以为耻	寡廉鲜耻	恬不知耻	无耻之尤	满不在乎	死皮赖脸
下游	卑劣	卑鄙	庸俗	粗俗	粗鄙	鄙俗	鄙俚	陋俗	俗气
下狱	坐牢	入狱
下班	放工
下笔成文	操翰成章
下等	劣等	粗劣
下落	着落
下里巴人	通俗易懂
阳春白雪	曲高和寡
不一而足	所在多有	不计其数	千千万万	成千上万	成千成万	不胜枚举	举不胜举	多如牛毛	数不胜数	比比皆是	不可胜数	不可胜计	不可枚举	不可胜举	不可胜言	不可胜道	不可计数	层出不穷	恒河沙数
不三不四	半间不界	半间半界	不伦不类	不正经	不僧不俗	非僧非俗	非驴非马
不上不下	处境尴尬	不求有功，但求无过	比上不足，比下有余	甘居中游	不稂不莠	不郎不秀	进退两难	进退维谷
不中听	不入耳
不丰不杀	不多不少
不为五斗米折腰	不为斗米折腰
不为人知	鲜为人知
不久	不多	未几
不乏其人	不胜枚举	大有人在	擢发难数	罄竹难书	不计其数	多如牛毛	数不胜数	更仆难数
不习水土	不服水土	水土不服	不伏水土
不二价	铁价
不亦乐乎	不可开交	淋漓尽致	酣畅淋漓	痛快淋漓	极尽描摹	大书特书	大块文章	洋洋万言	长篇大论	鸿篇巨制
不仅	不但	不光	不单	不只	岂但
不仅如此	不宁唯是
不伏手	不顺手
不伤脾胃	惠而不费	不伤大体
不作准	不作数	不当准
不佳	欠安
不便	未便
不修边幅	乱头粗服	粗服乱头	蓬头垢面	囚首垢面	不拘小节	不顾外表	落拓不羁	不拘形迹	不拘细形	不衫不履	洒脱不拘	放浪形骸	放荡不羁	无拘无束	荡检逾闲	挥洒自如	自由自在	落魄不羁	行云流水	诡衔窃辔
不值一提	何足道哉	不屑一顾	不足为外人道	不足挂齿	不过如此	不过尔尔	嗤之以鼻	何足挂齿	卑不足道	微不足道	无足挂齿	眇乎小哉	人微权轻	人微言轻
不假思索	搜索枯肠	不加思索	一举成功	一蹴即至	一蹴而就	迎刃而解	一挥而就	欲速不达	一目十行	五行俱下	五行并下	十行俱下	脱口而出
不偏不倚	秉公无私	中庸之道	不偏不党	不可偏废	统筹兼顾	公而忘私	大公无私	毫不利己，专门利人	公事公办	公正无私	秉公持正	一视同仁	天公地道	相提并论	等量齐观	忠言逆耳	良药苦口	持平之论	肺腑之言	至理名言	金玉良言
不偢不倸	不揪不睬	不理不睬	不瞅不睬
不偶	数奇
不克	不及	不能
不免	难免	未免
不入虎穴，焉得虎子	亲临其境
不再任用	永远贬抑
不决	未定
不准	禁绝
不凡	特殊	非凡	出格	分外	别致	新奇	特别1	迥殊	异常	异样
额定	规定
特别2	格外	非分	十分	很是	非常	额外
不出所料	果不其然	果然如此	料事如神	臆则屡中	先见之明	先知先觉	心中有数	明见万里
不分皁白	不顾曲直
不分高下	难分轩轾
不利	倒运	倒霉	晦气	背运
不劣方头	倔强不驯
不卑不亢	长揖不拜
不厌其详	不厌求详	纤悉不遗	细大不捐
不及	不迭
不可	不成	不行	弗成
不可动摇	见异思迁	不可移易	喜新厌旧	怜新厌旧	怜新弃旧	厌旧喜新	朝三暮四
不可同日而语	不可比拟
不可名状	不可言喻	不堪言状
不可捉摸	深不可测	高深莫测
不可置否	唯唯否否
不可言传	不可言宣
不吃不喝	不茶不饭
不吃烟火食	不食人间烟火
不合1	不同	分歧	差别	差异	错落	不一
不合2	不对	差池	差错	纰谬	舛讹	舛误	舛错	谬误	过失	过错	错误	误差
不合时宜	不达时宜	不入时宜	夏炉冬扇
不同凡响	与众不同	异乎寻常	天下第一	无出其右	天下无敌	天下莫敌	出类拔萃	只此一家，别无分店	天下无双	独一无二	独此一家	佼佼不群	超群出众	超群绝伦	鹤立鸡群	卓尔不群	独具匠心	独出心裁
不吝	不惜
不吝指教	不吝珠玉	不吝金玉	不吝赐教
不和	不和睦	纠纷
不堪	不胜
不外	不过
不够	不敷	不足	缺乏	无余
不够格	未入流
不夺农时	不违农时
不好	欠好	不妥	不当	欠妥
不妨	无妨
不学无术	目不识丁	空空如也	胸无点墨	不识之无	一无所知	一概不知	一窍不通	不得而知	不知所以	茫无所知
不学而能	生而知之
不宁不奈	不宁奈
不宁不耐	不宁耐
不守妇道	不安于位	不安于室	红杏出墙
不安分	不安本分
不容分说	不容置辩	无庸置辩
不容置喙	不容置疑	不由分说	不许插嘴	毫无疑义
不屈	不平	不服
不屈不挠	坚强不屈	坚韧不拔	百折不回	百折不挠	千磨万击	千锤百炼	百炼成钢	风吹浪打	风吹雨打
不平之鸣	不平则鸣	叫苦连天	喊冤叫屈	鸣冤叫屈	叫苦不迭	长吁短叹	抱恨终天	死不瞑目	不白之冤	含冤莫白	含冤负屈	沉冤莫白	衔冤负屈	覆盆之冤
不幸	出亡	劫难	厄运	多灾	多难	恶运	患难	磨折
不应	不该
不异	相同
不得不发	如箭在弦	矢在弦上	箭在弦上
不得人心	深入人心	亲痛仇快	众叛亲离	家喻户晓	户告人晓
不得善终	天诛地灭	不得其死	不得好死	天理昭彰	天理难容
不必	不消	不用
不忘本	有良心
不快	愁闷	抑郁	沉闷	烦懑	烦闷	纳闷	郁悒	疑惑	迷惑	勾引	蛊惑	诱惑	引诱
不快不慢	不疾不徐
不怕官，只怕管	现官不如现管
不惑之年	人到中年
不惜代价	不惜工本
不意	不料	不虞	出乎意料
不愧屋漏	暗室屋漏
不愿	不肯
不慎	失慎
不懂装懂	强不知以为知
不成体统	有失体统
不成才	不成材	不长进
不才	鄙人	干才	庸才	在下
不打不成相与	不打不成相识	不打不相识
不搭嘴	不搭腔	不答腔
不教而杀	不教而诛
不敢则声	吞声忍气
不敢造次	慎重其事
不敢问津	无人问津	置之不理	一笑了之	一笑置之	付之一笑	付诸一笑	嫣然一笑
不敢高攀	高攀不上
不日不月	没日没夜
不明事理	不知轻重
不曾	未曾
不期而遇	久别重逢	旧雨重逢	一面之交	萍水相逢	邂逅相遇
不欺暗室	暗室不欺	光明磊落	襟怀坦白	大公无私	正大光明	不惭屋漏	不愧屋漏	光明正大	铁面无情	铁面无私	为国损躯	公而忘私	公而无私	公耳忘私	名正言顺	堂堂正正	大公至正	大义灭亲	秉公灭私	不徇私情	六亲不认	舍己为公	安忍无亲
不正之风	歪风邪气	左道旁门	歪门邪道	旁门左道	邪门歪道	邪魔外道	鸡鸣狗盗
不死即伤	非死即伤
不治自愈	不药而愈
不法	造孽	非法
不法之徒	不逞之徒	亡命之徒
不测	意外
不烂之舌	钉嘴铁舌	铁嘴钢牙
不然	否则
不理	不睬
不用着急	毋须着急
不由	不禁
不由得	忍不住	禁不住
不留心	不留神	不小心
不登大雅	不登大雅之堂
不白之冤	沉冤莫白	沉冤莫雪	负屈含冤	屈打成招	私刑逼供	苦打成招	不打自招	欲盖弥彰	此地无银三百两	供认不讳	原形毕露	图穷匕见	图穷匕首见	暴露无遗	真相大白
不相闻问	断绝往来	不相往来	不通水火
不省人事	昏迷不醒
不看僧面看佛面	不看金面看佛面
不知不觉	不识不知	人不知，鬼不觉	神不知，鬼不觉
不知内情	不知就里	一无所知	不知所以	心中无数	一窍不通	全无所闻	无所不知	无所不通	不甚了了	茫然不解	雾里看花
不知利害	不知天高地厚	不知深浅	不知进退	不知高低	初生牛犊
不知薡蕫	不辨菽麦	五谷不分
不祥	吉利	吉祥	祥瑞
不立文字	口传心授	口耳相传
不管	不论	岂论
不经一事，不长一智	吃一堑，长一智	经一事，长一智
不置一词	不置可否	不置褒贬	含糊其词	模棱两可	不阴不阳	依违两可	模棱两端
不胜杯杓	不胜酒力
不能尽数	不能胜数
不能赞一词	不能赞一辞
不舞之鹤	无能之辈
不要紧	没关系
不见圭角	不露圭角	不露锋芒	深藏不露	守愚藏拙	深藏若虚
不见棺材不下泪	不见棺材不落泪
不记前仇	不记前嫌
不讳之路	不讳之门
不识好歹	不识抬举	不中抬举	不受抬举	不知好歹	是非不分	混淆黑白	泾渭不分	牝牡骊黄	混淆是非	混淆视听	皂白不分	颠倒是非	黑白不分
不识时务	不识时变	吃米不知米价	不识起倒	因循守旧	墨守成规	安于故俗，溺于旧闻	率由卓章	率由旧章	萧规曹随	一如既往	故步自封	陈陈相因
不请自来	不速之客
不足为凭	不足为据	捕风捉影	无案可稽	道听途说	荒诞不经	荒谬绝伦	大谬不然	大错特错	子虚乌有
不足介意	无足挂齿	不必介意	不足为意	无伤大体	无伤大雅	无关大局	无关大体	无关大雅	无关宏旨	无关痛痒	无关紧要
不辱使命	幸不辱命	不负众望
不进则退	逆水行舟	知难而进	逆流而上
不通	欠亨
不闻不问	矫柔造作	虚张声势	装模作样	装聋作哑	装腔作势	铺眉苫眼	做张做势	做张做智	做张做致	簸土扬沙	虚晃一枪	忸怩不安	忸怩作态	惺惺作态	扭扭捏捏	无病呻吟	冒名行骗	招摇撞骗	巧立名目	弄虚作假	掩人耳目	故弄玄虚	欺上瞒下	不择手段	乘伪行诈	平心而论
不雅	不雅观
不露声色	不露神色	剜肉医疮	剜肉补疮	挖肉补疮	杀鸡取卵	不留余地	牵萝补屋	竭泽而渔	饮鸠止渴	饮鸩止渴	不动声色	若无其事	面不改色
不顾	掉臂
不齿于人	狗彘不如
与人为善	助人为乐	慷慨解囊	解衣推食	解衣衣人	救困扶危	救苦救难	急公好义	成人之美	解囊相助	侠肝义胆	见义勇为	一臂之力	乐善好施	舍生取义	好善乐施	行善积德	孤注一掷	铤而走险
与你何关	干卿底事
丑陋	貌丑
专任	专权	专注	擅权	独霸	飞扬跋扈	垄断
专制	独裁
专心	用心
专程	特地	特意
专长	拿手	特长
世世代代	生生世世	万古千秋	万古长存	万古长青	千秋万代	千秋万岁	天长日久	流芳千古	欣欣向荣
世人	众人
世代书香	书香门户	书香门第	家学渊源
世代相传	代代相传
世伯	父执
世外桃源	极乐世界	天府之国	洞天福地	鱼米之乡	及时行乐	炳烛夜游	秉烛夜游	神仙世界	今朝有酒今朝醉
世易时移	事过境迁	情随事迁	时过境迁	明日黄花	彼一时，此一时	时移俗易	岸谷之变	沧海桑田	白云苍狗	东海扬尘
世界	全国	天下
世界大同	天下一家	天下为公
世道沦亡	人心不古
世间	凡间	尘世	尘凡	尘寰	尘间	红尘
业务	营业
丛林	森林
丛聚	簇集
丛集	猬集
东主	东主店东	东家	店东	店主	雇主
东偷西摸	小偷小摸
东奔西走	到处奔跑	东奔西跑	浪迹天涯	萍踪浪迹	断梗飘蓬	漂泊不定	萍飘蓬转	飘蓬断梗	走南闯北	东奔西撞	东碰西撞
东寻西觅	东搜西罗
东山再起	卷土重来	另起炉灶	重整旗鼓	死灰复燃	死灰复然	借尸还魂
东床	半子	女婿
东床坦腹	东床娇客	乘龙佳婿	乘龙快婿	骐骥才郎
东抹西涂	东涂西抹	擦脂抹粉	胡写乱画	施脂着粉	油头粉面	浓妆艳抹	淡扫蛾眉	浓装艳裹	花枝招展	涂脂抹粉
东拉西扯	不着边际2	夸夸其言	放言高论	海说神聊	高谈阔论	天花乱坠	无的放矢	离题万里	空洞无物	花言巧语
东拦西阻	百般阻挠
东挪西借	东挪西凑	七拼八凑	东拼西凑	东拉西扯	乱点鸳鸯	人迹罕至	地广人稀	地旷人稀	渺无人烟	地大物博	幅员辽阔	海阔天空	说东道西	谈天说地	巴三览四
东洋	东瀛
东游西荡	东游西逛
东藏西躲	东躲西藏
东西	器材	器械	对象	工具
东逃西窜	豕突狼奔
东道主	东道主人	北道主人	东道之宜	地主之谊
东遮西掩	遮遮掩掩
东郭先生	好好先生
东零西散	东零西碎
东风	春风
东风吹马耳	当耳边风	无动于衷	漫不经心	毫不在意	漠不关心	不以为意	掉以轻心	不关痛痒	了不相涉	草率收兵	草草了事	草草收兵	马马虎虎	粗心大意	麻痹大意	充耳不闻
东飘西泊	东飘西荡
丝毫	涓滴
丝毫不爽	谬误百出
丢三落四	差三错四
丢卒保车	丢车保帅
丢失	丧失	损失	失落	掉	失踪	失
丢弃	扔掉	扬弃	抛弃	甩掉	屏弃	摈弃	摈斥	摒除
丢盔弃甲	割须弃袍	落花流水	一败涂地	丢盔卸甲	狼奔豕突	落荒而逃	狼狈不堪
丢脸	难看	好看	悦目	顺眼	美观	都雅	雅观
两全	兼顾	分身	统筹
两姓之好	秦晋之好	天作之合	秦晋之缘	终身大事	美满良缘	房谋杜断
两小无猜	总角之交	指腹为婚	青梅竹马	儿女情长	卿卿我我	情同手足	良师益友	良师诤友	莫逆之交	亲密无间	手足之情	鸠车竹马
两败俱伤	兰艾同焚	同归于尽	人财两空	鸡飞蛋打	玉石俱焚
严严实实	结结实实
严以律己	引咎自责	严于律己	反求诸己	反躬自问	闭门思过	知错必改	闻过则喜	徒唤奈何	悔不当初	悔之晚矣	自怨自艾	追悔莫及	悔之不及	悔之无及	悔恨交加	反躬自省
严刑	酷刑
严容	厉色
严寒	冰冷	冰凉	寒冷	极冷	酷寒
严峻	严明	严格	严正	严重	峻厉	重大	严厉
严惩	严罚	重办
丧事	凶事
丧家之犬	漏网之鱼	人心所向	众矢之的	过街老鼠	年高德劭	年高望重	德高望重	众星拱辰	众星捧月	众望所归	深得人心
丧母	失恃
丧气	沮丧
丧生	回去	弃世	归去
丧魂失魄	六神无主	坐立不安	失魂落魄	如坐针毡	忐忑不安	芒刺在背	食不甘味	黯然销魂	魂飞魄散	五色无主	慌慌张张	慌手慌脚	慌里慌张	惊慌失措	惶恐不安	手忙脚乱	临阵脱逃	六神不安	心神不定	惊惶万状	贪生怕死	惊魂不定	惊魂未定	自相惊忧	张皇失措	惊惶失措
个人	小我	自我	小我私家
个人主义	本位主义
中伤	毁谤	离间	讪谤	诋毁	诬蔑	诽谤	扭曲	歪曲	污蔑
中兴	再起	复兴
中分	平分	等分
中午	午时	正午
中原	华夏
中原逐鹿	逐鹿中原	虎斗龙争	鹿死谁手	龙争虎斗	决一胜负	决一雌雄	勾心斗角	明争暗斗
中央	中心	中间
中心人物	核心分子
中怀怨恨	仇隙在心
中断	中止	中缀	伏贴	停当
中用	顶用
中西合璧	亦中亦西	土洋结合
中选	当选	被选	入选
中途	半途
丰产	丰收	丰登	歉收
丰功伟绩	功名盖世	功标青史	汗马功劳	不世之功	不赏之功	盖世之功	公垂竹帛	功德无量	劳苦功高
丰厚	丰裕	丰饶	优裕	厚实	富余	富厚	富裕	富足	富饶	敷裕	足够	雄厚	饶富
丰富	丰度	丰盛	丰硕	充分	充实	充沛	充盈	充裕	充足	品貌
丰年	乐岁	康年	熟年	有年	歉年
丰满	饱满
丰衣足食	小康之家	暖衣饱食	自给自足	饱食暖衣	人给家足	安家乐业	安身乐业	家给人足	国泰民安	安居乐业	家给民足
丰采	神姿
串亲访友	走亲访友
串连	串通	勾串	勾搭	勾结	勾通	通同
临别赠言	临别赠语
临川羡鱼	临河羡鱼	临渊羡鱼
临深履薄	履薄临深	履冰临渊	盲人瞎马
临渴掘井	悔之莫及	江心补漏
临蓐	分娩
丹心	兰交	至交	至好	赤心
丹方	方剂	方子
丹舟共济	以沫相濡	濡沫涸辙	相濡以沫	爱屋及乌	屋乌之爱
丹青	图画
丹青妙手	美术大师	妙手回春	药到回春
为人作嫁	代人受过	舍己为人
为人处世	待人接物	人情世故	人情冷暖	立身处世	世态炎凉	悲欢离合	酸甜苦辣	人之常情
为人师表	率马以骥
为国捐躯	克己奉公	公而忘私	国尔忘家	奉公守法	廉政无私	慷慨就义	谦洁奉公	乐天知命	安分守己	安守故常	循规蹈矩	规行矩步	规规矩矩
为德不卒	有始无终	虎头蛇尾	龙头蛇尾	有头无尾	心猿意马	意马心猿	三心二意	心不在焉	心烦意乱	心神不定	漫不经心	魂不守舍	一暴十寒	一曝十寒	两意三心	为德不终	朝三暮四	见异思迁	五心六意	朝秦暮楚	优柔寡断	筑室道谋	筑舍道傍
为虎傅翼	如虎添翼	为虎作伥	为虎添翼	助纣为虐	助桀为虐	助天为虐
主办	主理
主动	自动	自发	自觉
主干	骨干
主座	长官
主持	掌管
主旨	大旨	宗旨
主犯	正犯	首犯
主笔	编缉
主要	重要	首要
主顾	顾主	顾客
丽都	华丽	华美	都丽
举事	发难	起事
举例子	打比方
举动	勾当
举动当作	算做
举国上下	朝野上下
举国若狂	纵情欢乐
举头	俯首	昂扬	昂首	高昂	仰面	抬头
举家	全家	合家	百口
举家上下	全家老少	阖门百口
举杯	碰杯
举止	活动	流动	运动
举目无亲	孤苦伶仃	离群索居	鳏寡孤独	人地两生	人地生疏	六亲无靠	无依无靠
举目皆是	俯拾即是	比屋可封	比比皆是	比比皆然	漫天遍野	漫山遍野	俯拾地芥	如拾草芥	不知凡几	不胜枚举	触目皆是	星罗棋布	鳞次栉比	堆积如山	雨后春笋	为数众多
举鼎绝膑	力所不能	力不能及	蚍蜉戴盆	蚍蜉撼树
乃至	以至	以致	甚至	致使
久旱盼雨	大旱望云
久旱逢甘雨	他乡遇故知	天从人愿	如愿以偿	称心如意	差强人意	心满意足	志得意满	意得志满	踌躇满志	谢天谢地	恰如私愿	正中下怀	乐无知命	尽如人意	知足常乐	自得其乐
久经沙场	能征惯战
久而久之	天长地久	长年累月	长此以往	天长日久	经年累月	经年累稔	连年累岁	日久天长
久远	长远
义兵	义军	义师
义冢	公墓
义士	烈士
义愤填膺	拍案而起	义正辞严	辞严义正	理直气壮	义正词严	名正言顺	义形于色	义无反顾	天怒人怨	满腔义愤
义正词严	念念有词	振振有词	振振有辞	涛涛不绝	理直气壮	力排众议	据理力争	心安理得	衾影无惭	问心无愧	问心有愧	光明磊落	扪心无愧
义父	寄父	干爹
乌七八糟	乱七八糟	污七八糟	杂乱无章	横七竖八	乌烟瘴气	凌乱不堪	一团乱麻	东倒西歪	东歪西倒	前仰后合	前合后仰	七颠八倒	井井有条	五角六张
乌青	铁青
乌鸟私情	慈乌反哺
乌龟	绿头巾	无赖	忘八	混蛋
乍寒乍热	忽冷忽热
乐不可支	乐不思蜀	乐而忘返	欣喜若狂	乐不可言	兴高采烈	其乐无穷	喜出望外	大喜过望	乐在其中	乐此不疲	流连忘返	奔走相告	沉迷不醒
乐不可极	乐不极盘
乐律	音律
乐昌分镜	乐昌破镜
乐极生悲	兴尽悲来
乐此不疲	兴致勃勃	津津乐道	津津有味
乐音	噪音
乔妆	改扮
乔迁	燕徙
乔迁之喜	喜迁新居	出谷迁乔
乖僻	古怪	奇异乖张	离奇
乖巧	机敏	机智	机灵	机警	灵巧
乖戾	堕落	狠恶	侵蚀	腐蚀	蜕化	侵害	损伤	损害	毁伤
乖谬	谬妄	乖张	荒谬	怪僻	怪诞	神怪	荒唐	荒诞
乘凉	纳凉
乘坚策肥	乘坚驱良
乘客	搭客
乘胜追击	乘胜逐北
乘船	搭船公私分明
乘车	搭车
乘隙	趁机
乘风破浪	长风破浪	披荆斩棘	披荆棘	高歌猛进
乘鸾跨凤	乘鸾配凤
九月	玄月
九泉	地府	鬼门关
九泉之下	重泉之下	阴曹地府
乞丐	叫花子	托钵人
乞假	告假	正告	请假	销假
乞贷	借债	借款	告贷	借钱
乞降	屈膝投降	投降	求和	降服佩服
乞食	托钵	讨饭
习俗移人	习俗移性
习尚	风俗	风尚	风气	习俗	习惯	风俗世情	风土人情	习气
习焉不察	习而不察
习用	惯用	习与性成	习惯成自然	习惯自然
习非成是	习非胜是
乡下	乡间
乡亲	同乡	同亲
乡人	村夫
乡俗	土风
乡信	家书	家信
乡镇	州里
书函	书札	书柬	书牍	书信	手札
书厨	书柜	书橱
书生	墨客	诗人	骚人
书画	字画
书箧	书箱
书籍	册本	书本	书简
书记	公告	布告	通知布告	告示	通告	告知	奉告	示知	见告	见知
书院	学堂	私塾
书页	册页
买东买西	买这买那
买办	大班
买空卖空	勾心斗角	卖空买空	投机取巧
乱世	浊世	盛世
乱弹琴	瞎胡闹
乱来	瞎搅
乱说	胡说
乳母	奶妈	干娘	谊母
乾坤	六合	天地	寰宇
了偿	偿还	出借	归还	清偿	送还	了债
了望	眺望	瞭望	远望	遥望
了结	告终	完结
了解	相识
予人口实	授人口实	贻人口实	遗人口实
争取	夺取	攫取	篡夺	争夺	抢夺
争名夺利	争强好胜	争权夺利	明争暗斗	钩心斗角
争艳	斗丽
争锋吃醋	争风吃醋	妒贤嫉能
事与愿违	南辕北辙	救经引足	各走各路	背道而驰	大失所望	适得其反
事主	本家儿	正事主
事倍功半	力倍功半
事关重大	兹事体大
事后诸葛亮	马后炮
事实	实际	现实
事必躬亲	身体力行	一本正经	不苟言笑	道貌岸然	以身作则	言传身教	身先士卒	上行下效	现身说法	盂方水方
事故	变乱
事理	道理	原理	情理
事迹	古迹	奇迹	事业	奇观	异景
二八佳人	妙龄少女
二天之德	再造之恩	再生父母	恩同再造	恩重如山	重生父母
二心	他心	贰心
二月	仲春
于事无补	斗升之水	无济于事	杯水车薪	船到江心补漏迟	杯水救薪	人浮于事	僧多粥少
于归之喜	出阁之喜
亏得	好在	幸亏	幸好	幸而
亏心	负心
亏本	折本	蚀本	赔本
亏蚀	损耗	消磨	消耗	耗损	耗费	斲丧	花消	花费
云云	如斯	如此
云净天空	云过天空
云合景从	云集景从
云合雾集	云屯雾集
云烟过眼	过眼烟云	过眼云烟
互不侵犯	各不相犯
互不相让	各不相让	各执己见	各抒己见	各抒所见	各持己见	各执一词	言人人殊	各自进行	各行其是	同心同德
互助	协作	单干	合作	相助
互市	通商
互教互学	教学相长
互相	相互	彼此
互相研究	切磋琢磨
互通有无	有来有往	礼尚往来	投桃报李	取长补短	酌盈剂虚	酌盈注虚	就事论事	扬长避短	避实就虚	舍短取长	有无相通
五十步笑百步	龟笑鳖无尾
五方杂厝	五方杂处	龙蛇混杂
五月	蒲月
五脏六腑	五藏六府	骨子里面
五风十雨	十风五雨	风调雨顺	五谷丰登	人寿年丰	六畜兴旺
井然有序	有条不紊	鱼贯而入	有条有理	有板有眼	丝丝入扣	环环相扣	擘肌分理	条理清晰	井井有序	井井有条	头头是道	秩序井然
抑扬顿挫	轻重缓急	缓急轻重	错落有致
井蛙语海	鷽鸠笑鹏
亚肩迭背	肩摩毂击	肩摩毂接
亡国之音	靡靡之音
亡故	物化
亡羊补牢	顾犬补牢	来者可追	见兔顾犬	贼去关门
交兵	兵戈	干戈	打仗	接触	构兵
交叉	穿插
交口称赞	有目共赏	交口称誉	有口皆碑	洛阳纸贵	都中纸贵
交心	谈心
交恶	反目
交情	友好	友爱
交战	征战
交手	交锋	比武
交易	生意业务
交替	瓜代
交浅言深	话不投机	称雨道晴	语不投机
交谪	吵骂
交运	行运	走运
亥豕相望	鲁鱼亥豕	鲁鱼帝虎
亦步亦趋	唯命是从	马首是瞻
产品	产物
产生	发生	迸发	孕育发生
亨衢	大路	通衢
亨通	利市
享受	享用
享福	受罪	纳福
京城	国都	城市	都会	都城	都邑	首都
京师	京都	毂下	都门
京彩	皮蛋
亭亭玉立	袅袅婷婷	风仪玉立
亭台楼阁	楼阁台榭
亮光	光亮	光洁
亮堂堂	黑压压	黑糊糊	黑黝黝
亮相	表态
亲串	戚属
亲事	婚事
亲信	心腹	知己	良知
亲信背叛	舟中敌国	后继无人	孤家寡人	孤苦伶仃	形单影只	形影相吊	断子绝孙	众叛亲离	打成一片
亲友	亲朋
亲如手足	情同手足	深情厚意	深情厚谊	称兄道弟	骨肉深情	交谊	友情	友谊	如兄如弟	情同骨肉	一人之交	不分彼此	不分畛域	心心相印	息息相关	息息相通	患难与共	志同道合	情投意合	情逾骨肉
亲密	亲昵	亲热	密切
亲属	支属
亲自	亲身	切身
亵服	内衣
亵渎	侮慢	轻渎
人一己百	笨鸟先飞	坌鸟先飞	慢鸟先飞
人丁	人口	生齿
人不知	鬼不觉
人世	人间
人中表表	铁中铮铮
人云亦云	侏儒看戏	痴人说梦	矮人看场	矮人看戏	矮人观场	矮子看戏	矮子观场	随声附和	拾人涕唾	拾人牙慧	吠形吠声	侏儒观戏	吠影吠形	按图索骥	照本宣科	生搬硬套	述而不作	顺风使船	不求甚解	望文生义	顾名思义	囫囵吞枣	浅尝辄止	生吞活剥	食古不化
人亡物在	人琴两亡	人琴俱亡	人琴俱逝	睹物思人
人人	各人	大家1	大伙	集体	团体	整体	集团
人仰马翻	马仰人翻
人力车	黄包车
人去楼空	室迩人遐	一去不复返	人面桃花	室迩人远	室迩人遥
人员	职员
人命	性命
人命关天	草菅人命	非同小可	滥杀无辜	视如草芥	杀人如麻	生杀予夺	草薙禽狝
人喊马嘶	人困马乏	人声鼎沸	人欢马叫	震耳欲聋	响彻云霄	高唱入云	振聋发聩	龙吟虎啸	游响停云	响遏行云	响彻云际	震天动地
人地相宜	地利人和	天时地利	得天独厚
人定胜天	成事在人	谋事在人	事在人为	人众胜天
人工流产	堕胎	打胎
人心向背	得道多助
人性	人道	兽性
人情	情面
人才济济	藏龙卧虎	人才辈出	藏龙伏虎
人有旦夕祸福	天有不测风云
人杰地灵	地灵人杰	钟灵毓秀	鸾翔凤集
人死留名	豹死留皮
人烟	火食
人生如寄	人生若寄
人皆掩鼻	掩鼻而过
人祸	天灾
人穷志短	马瘦毛长
人算不如天算	千算万算，不值天一划
人缘	分缘	因缘
人老珠黄	老树枯柴
人莫予毒	莫予毒也
人证	物证
人近黄昏	半截入土
人造	天然	自然
人非木石	人非草木休戚与共	脉脉相通	血肉相连
什物	实物
仁至义尽	情至意尽	惨无人道	惨绝人寰	穷力尽心
仁言利博	仁言利溥
仅此而已	如此而已
仆人	仆役	佣人	家丁	西崽
仆从	奴才	奴隶	扈从	跟随	追随	跟从	跟班	随从	尾随
仆众	奴仆	奴婢
仆欧	侍役	侍者	跑堂
仇人	仇家	仇敌	对头	敌人
仇人相见，分外眼红	仇人见面，分外眼红
仇视	敌视
今世	古代	当代	摩登	现代
今人	前人	古人	后人	昔人
今夜	彻夜	通宵
今天	今日	本日
今年	本年
今是昨非	昔不如今	今是昔非	今非昔比	日新月异	健步如飞	大步流星	急若流星	追风逐电	风驰电掣	一日千里	与日俱进	日行千里
今生	此生
介绍	先容
从兄弟	堂兄弟
从军	参军
从前	夙昔	早年	畴前
从古到今	古往今来	亘古亘今
从天而降	出乎意料	突如其来	从天而下	猝不及防	防不胜防
从头彻尾	从头至尾	彻头彻尾	自始至终	从头到尾	原原本本	善始善终	有头有尾	有始有终	彻上彻下	彻里彻外	彻内彻外	彻心彻骨	彻首彻尾	滴水不漏	点水不漏	一五一十	一清二楚	一清二白	一目了然	不折不扣	历历可数	历历在目	实事求是	黑白分明
从容自在	从容自若	从容自如	忤者张天民创业：华程	镇定自若	坦然	安然	安全	安然无恙	安稳	平安	平安无事	平稳	不慌不忙	僻静	和平	太平	宁静	安好	安祥	安详	安适	安静	平静	沉静	静谧
从宽发落	法外施仁	法外施恩	不咎既往	不追既往	既往不咎	宽大处理	手下留情	既往不究
从属	附属	隶属
从心所欲	得心应手	心手相应	挥洒自如	操纵自如	运用自如	轻车熟路	驾轻就熟	予取予求	力所能及	力挽狂澜	大方之家	斫轮老手	识途老马	老马识途
从恶如崩	从恶若崩
从戎	当兵	投军	荷戈
从来	历来	不时	时时	一直	不休	不停	不息	不断	不竭	不绝	接续	络续	赓续	一向	一贯	向来	始终	素来
从速	赶忙	赶快	赶紧	连忙
仓促	仓卒	仓猝	仓皇	匆促	匆匆	匆急	吃紧	急促	急忙	急急	短促	急遽
仓库	堆栈	客栈	旅馆	货仓
仔细	卖力	当真	细心	认真
仔细琢磨	反复推敲
仕宦	官吏
仕进	做官
仕途	宦途
他乡	异乡	异域
他人	别人
他山之石	参考之资
他日	另日	异日	择日	改日	未来	畴昔
仗义执言	打抱不平	扶弱抑强	拔刀相助	拔刀相济	见义勇为	济困扶危	济困解危	雪中送炭	仗义疏财
仗马寒蝉	噤若寒蝉	张口结舌	张目结舌	瞠目结舌	默不作声	默默无言
付与	授予	给予	给以	赋予	赐与	赐予	赐赉
付出	支付
付梓	刊行	发行	排印
仙丹	灵药
仙人	神仙
仙境	瑶池
仙游	升天
仙颜	美貌
仙风道骨	品格清高	品格清高瘦骨如柴	瘦骨如柴	仙风道气
代价	价值	价格	价钱
代办	代劳	代庖
代办署理	代理	署理
代替	取代	替代	庖代	替换
代马依风	代马望北	狐死首丘	月是故乡明	越鸟南栖面目一新
令人着迷	引人入胜	别有天地	别有洞天	流连忘返	依依不舍	相持不下	难分难舍	难舍难分	难解难分	恋恋不舍	悠悠忘返	流连忘反
令嫒	掌珠
以一为十	以一当十	以寡敌众	以少胜多	以弱胜强
以为	觉得	认为	感觉
以人为鉴	以人为镜
以其人之道	还治其人之身
以其人之道，还治其人之身	将计就计	以毒攻毒	以牙还牙	请君入瓮	以眼还眼	以暴易暴	针锋相对
以后	当前	今后
以夷伐夷	以夷制夷	以夷治夷	借刀杀人	暗箭伤人	存心不良	居心不良	居心叵测	冷箭伤人	心中有鬼	心怀叵测	心怀鬼胎	暗箭中人	笑里藏刀
以屈求伸	以柔克刚	瞒上瞒下	瞒天昧地	瞒天瞒地	掩人耳目	瞒上欺下	瞒天过海	欲盖弥彰	此地无银三百两	以守为攻	以攻为守	以退为攻	以退为进	后发制人	故作姿态
以强凌弱	弱肉强食	优胜劣败	倚势凌人	倚强凌弱	适者生存	仗强欺弱
以德爱人	爱人以德
以怨报德	恩将仇报	以义割恩	反戈一击	反脸无情	忘恩负义	翻脸无情	千恩万谢	背信弃义
以怪为常	司空见惯	见怪不怪	见怪未怪	习以为常	屡见不鲜	家常便饭	数见不鲜	熟视无睹	层出不穷	层见叠出	层见迭出	推而广之	百花齐放	遍地开花	绳床瓦灶	不可偻指算	不足为奇	多如牛毛	并世无双	无独有偶	更仆难数	不以为奇	比比皆是
以战去战	以杀去杀
以手加额	额手称庆	额首相庆	举手加额	举手相庆
以是	所以
以物易物	抱布贸丝
以狸致鼠	以狸饵鼠
以紫乱朱	善恶不分	黑白不分	是非不分	良莠不分	良莠不齐	薰莸同器	本末倒置	混淆是非	混淆视听	颠倒黑白	黄钟毁弃1
以耳为目	以耳代目
以莛叩钟	以莛撞钟
以蚓投鱼	千虑一得	引玉之砖	抛砖引玉	一得之见	井底之蛙	少见多怪	粤犬吠雪	蜀犬吠日	辽东豕	一孔之见	井底蛤蟆	坎井之蛙	坐井观天	一得之愚	一知半解	一得之功
以讹传讹	缪种流传	谬种流传	耳食之言	三人成虎
以词害意	以辞害意
以身试法	执法犯法	明知故犯	监守自盗	知法犯法	见利忘义	州官放火
以邻为壑	嫁祸于人	嫁祸他人
仪式	典礼
仰事俯畜	仰事俯育
仰慕	企慕	敬慕
仰望	俯视	仰视	企盼	俯瞰	瞻仰	鸟瞰
仰给	仰食
仰药	服毒
仰面朝天	四脚朝天
仲父	季父
仳离	离婚
价值连城	连城之璧	无价之宝	稀世之宝	价值千金
任人唯亲	任人唯贤	顺之者昌	人尽其才	量才录用	知人善用	知人善任	选贤举能
任凭	听凭
任务	工作	义务	使命	事变	事情	事项	事件	事故	变乱	事务	事宜
任命	录用
任性	任意	尽兴	尽情	恣意	率性	纵情	肆意	苟且	轻易	随便	随意	马虎
任达不拘	豪放不羁	豪迈不羁
任重道远	负重致远	不遗余力	竭尽全力	倾巢而出	全力以赴	尽心尽力	全心全意	尽力而为	尽心竭力
仿佛	好像	如同	宛如	宛然	宛若	犹如	似乎	彷佛
仿制	仿造
仿单	说明书
仿照	模仿	依然	模拟	照旧	仍是	照样	还是	仍旧	仍然	依旧	如故
企望	但愿	倒退	发展	希冀	希望	希翼	开展	心愿	成长	生长	进展
企求	希求
企足而待	指日可待	计日以待	计日可待	计日可期	计日程功	计日而待	为期不远	指日可下	不可企及	望尘莫及	瞠乎其后	小巫见大巫	相形见绌	黯然失色	不可逾越
伊于胡底	如何了局	不堪设想	不可思议	难以想象	百思不得其解	百思不解	百思莫解	大惑不解	深不可测	玄之又玄	高深莫测	不可名状	不可捉摸	不可胜言	不可言宣	不可言状	不堪言状	不知所以	咄咄怪事	玄而又玄	神乎其神	莫名其妙
伎俩	手段	手法	手腕	技能花样
伏乞	伏祈
伏低做小	做小伏低	巴结奉承
伏枥老骥	归隐志士
伏法	伏诛	受刑
伏罪	服罪
伏羲	宓羲
伏莽	盗匪
伐木	砍木	斩柴
伐罪	讨伐	诛讨
伐鼓	击鼓
休业	停业	收歇	歇业	破产
休会	闭会
休养	疗养
休咎	吉凶	福祸
休战	停战	寝兵	息兵
休止	截止	截至	遏制
众口一词	如出一口	异口同声	众口称善	口碑载道	不约而同	有口皆碑	誉不绝口	赞不绝口	赞口不绝	赞叹不已	击节称赏	拍案叫绝	拍桌惊叹	交口称誉	交口称赞
众口难调	莫衷一是	见仁见智	没衷一是
众怒	公愤	民愤
优哉游哉	优游卒岁
优待	优遇	厚待	厚遇	宠遇
优柔	娇嫩	柔嫩	柔软
优等	头等	甲第	甲等
优美	柔美	美丽	美好	富丽	瑰丽	绮丽	雄壮	丑恶	俊丽	俏丽	斑斓	标致	漂亮	秀丽	秀媚	艳丽	锦绣	鲜艳	英俊	雄浑
优胜	优越
优良	昂贵	高档	高等	高级	优异	优秀
伙伴	同伴	搭档	火伴
伙头	厨子	庖丁	火头
伙计	伴计	店员
伙食	炊事	膳食
会合	会集	搜集	汇合	汇集	聚集	集中	集合	齐集
会堂	礼堂
会心	会意
会演	调演
会聚	汇聚	集聚
会计	司帐	管帐
会餐	聚餐
传为佳话	传为美谈
传为笑柄	传为笑谈
传宗接代	后继有人	青出于蓝	冰寒于水	后来居上	后起之秀	青胜于蓝	青出于蓝而胜于蓝	后发先至
传布	传播	传达	流传	传递	转达	通报
传扬	外扬
传授	教授
传播鼓吹	声称	宣称
传教	布道
传杯弄盏	传杯换盏	传杯送盏
传染病	流行症
传神	真切	逼真
传经送宝	传道授业
传记	列传
传译员	翻译员	通译员
传说风闻	传闻	风闻	听说	据说
传颂	奖饰	歌咏	歌唱	歌颂	称扬	称誉	称赞	称道	称颂	讴歌	赞叹	赞扬	赞美	赞颂	颂扬	表彰	表扬	褒扬	赞誉	嘉赞	欣赏	赏识	赞赏
伤亡枕藉	血肉横飞
伤害	挫伤	危险
伤心惨目	惨不忍睹	惨不忍言	惨不忍闻	惨绝人寰	惨无人道	灭绝人性	心狠手辣	残酷无情	目不忍睹
伤悼	哀伤	悼念
伤时感事	忧国忧民
伤痕	创痕
伤风	感冒
伪装	假装
伪钞	假票
伫候	鹄候
伫立	鹄立
伯乐相马	伯乐选马
伯仲	手足	昆季	转战南北	戎马倥偬	戎马生涯
伯仲叔季	甲乙丙丁
估客	商人	贩子	市井	街市	街市商人
估算	预算
估计打算	盘算推算
伴侣	佳耦	匹俦	夫妇	妃耦	配偶	配头	佳偶	良伴
伴随	陪伴	随同	陪同	伴同
伶丁	孤苦
伶人	戏子
伶俐	堵塞	梗塞	窒息	聪慧
伸展	皱缩	舒展
伸开	张开
伸张	蔓延
伸手不见五指	黑乎乎	黑漆漆
伺探	侦察	窥伺
伺隙	俟机
似是而非	张冠李戴	破绽百出	以假乱真	似真似假	鱼目混珠	貌同实异	不足为法	不足为训	东窗事发	原形毕露	露出马脚	丑态毕露	图穷匕见	尖嘴猴腮	以子之矛，攻子之盾	函矢相攻	自相矛盾	漏洞百出	错误百出	真相大白
佃农	房客
佃户	田户	耕户
但凡	凡是	寻常	常日	平常	平日	每每	素日	通常	平凡	平居	平平	平庸	平时	平淡	往常	日常	泛泛	清淡	油腻
但是	可是	然则	然而
位置	地位	职位地方
低劣	低廉	低档	低等	低级	初等	初级	差劲
低头	垂头
低头屈膝	低首下心	低三下四	善解人意	投其所好	曲意奉迎	曲意逢迎	趋炎附势	卑躬屈膝	奇耻大辱	奴颜婢膝	奴颜媚骨	胯下之辱	低声下气	低眉顺眼	俯首帖耳
低头搭脑	低头耷脑
低微	卑微	微贱	寒微	卑下	卑贱	猥贱
低沉	低潮	低落	消沉	降低
低进高出	贱买贵卖	贱敛贵出	贱敛贵发
住宅	住所	室庐	室第	居处
住持	方丈	住持僧人	当家和尚	方丈和尚
住民	居民
体会	体味
体例	编制	体式	格局	格式	模式
体制	体系体例
体态	身形
体无完肤	皮开肉绽	遍体鳞伤	伤痕累累	鳞伤遍体
体系	系统
体育场	运动场
体裁	文体
何为	作甚
何以	何故
何关	何干
何况	况且
何在	安在
何堪	那堪
何处	哪里
何如	假如	假定	假设	奈何	如何	如果	怎么	怎样	若何	若何怎样	若是	要是
何必	何须
何等	多么	如许	这样
余存	孑遗
佛学	梵学
佛寺	梵刹	梵宇
佛教	释教
作业	功课
作别	道别
作声	出声
作对	尴尬	刁难
作弊	舞弊
作恶	作歹	作怪	作祟	拆台	捣乱	捣蛋	捣鬼
作育	培养	培育	种植	建设	汲引	栽培	栽种	莳植	抚育	哺育	培植	扶养	扶植	抚养	供养	哺养
作贼心虚	做贼心虚	贼胆心虚	贼人胆虚	运筹决策
作陪	奉陪
你的意见	高见	卓见	卓识
佣钿	回佣
佩带	佩戴
佩服	拜服	敬佩	信服	服气	钦佩
佳人	才子
佳偶天成	嘉偶天成
佳兵不祥	兵凶战危
佳肴	好菜
佳誉	美誉
佳话	美谈	韵事
佻达	浮薄	轻浮	浮滑	轻浮	轻狂	轻薄	佻薄
使劲	用力
使女	女仆	婢女	梅香
使气	生气	负气	赌气
使用	利用
使者	使臣	青鸟使
侈侈不休	呶呶不休	喋喋不休	千言万语	千语万言	口若悬河	津津乐道	滔滔不绝	一言半语	三言两语	只言片语	简明扼要	言简意赅	长篇累牍	断墨残楮	断简残编	片纸只字	片言之语	残篇断简	片言只字
侈靡	奢侈	奢靡	豪侈
例如	好比	比喻	比如	比方	譬喻
例行公事	官样文章	等因奉此	例行差事
侍从	随从
供不应求	粥少僧多	求过于供	人浮于事	僧多粥少	十羊九牧
供应	供给	提供
供认	承认	抵赖	招认	狡赖	认可	招供
供词	口供	笔供
依从	允从
依样葫芦	葫芦依样	维持原状	上行下效	如法炮制	鹦鹉学舌	邹缨齐紫
依法办事	依法惩处	军法从事
依照	按照	遵循	遵照	依据	凭据	根据	凭证
依附	附丽	委托	托付	拜托	奉求	寄托	请托	仰仗	依托	依赖	依靠	倚赖	凭仗	凭借	寄予
侥幸	幸运	荣幸
侦探	侦骑	逻骑
侦缉队	刑警队
侧丽	侧艳
侧重	偏重	并重	着重
侨民	外侨
侯服玉食	锦衣玉食	灯红酒绿	纸醉金迷	花天酒地	醉生梦死	金迷纸醉	钟鸣鼎食	穷奢极侈	鼎铛玉石	娇生惯养	骄生惯养	大吃大喝	大块朵颐	大肆挥霍	铺张浪费	食前方丈	肉山脯林	荒淫无度	酒池肉林	暴殄天物
侯门似海	侯门如海
侵吞	并吞	占领	攻下	攻克	攻陷	霸占	占据	占有
便函	私函
便利	便当	利便	方便
便宜	克己	廉价	自制
便是	即是	就是	等于
便服	燕服
便条	条子
促成	促进
促膝谈心	把臂而谈
俊彦	翘楚
俊逸	潇洒	萧洒	飘逸
俎上肉	釜中鱼
俗不可耐	鄙俗不堪	不堪入耳	污言秽语	伤风败俗	有伤风化	移风易俗	不堪入目	卑鄙龌龊	行同狗彘	变古易常	破旧立新
俗儒	陋儒
俗语	俚语	鄙谚
保举	推举	推荐	选举	举荐	引荐
保全	顾全
保养	调养	颐养
保卫	守卫	守护	捍卫	警备	守御
保国安民	保境息民	保家卫国
保存	保留	保管	留存	临盆	出产	消费	生产	生活	生涯	糊口	生计
保守2	守旧
保密	保守秘密
保持	僵持	坚持	对峙	抛却	摒弃	放弃	连结	相持
保藏	收藏	珍藏
保证	保障	包管	担保
保重	珍重
保镳	警卫
信以为真	坚信无疑
信件	函件	简牍	翰札
信任	信托	信赖	相信	置信
信号	旌旗灯号
信奉	崇奉	信仰
信心	信念	决心
信手拈来	顺手牵羊	垂手而得	触手可及	轻而易举	唾手可得	易如反掌	一挥而就	手到擒来	探囊取物	举手之劳	顺风吹火	火上弄冰	吹灰之力	手到拈来
信用	信誉	诺言
信赏必罚	赏罚分明	赏罚严明
信马游缰	信马由缰
俭以养廉	俭可养廉
俭省	勤俭	勤恳	熟谙	节俭
修业	求学	肄业
修养	涵养	教养
修复	复原	还原
修好	修睦
修建	建筑	构筑	修筑
修心养性	澡身浴德
修缮	缮治	补葺	修理	补缀	缝补
修订	勘误	校勘	考订	订正
修长	细长	颀长
修饰	润色	润饰
俯仰由人	俯仰随人	举夺由人	仰人鼻息	寄人篱下	傍人依户	傍人篱壁	傍人篱落	傍人门户	身不由己	昌亭旅食
俯冲	爬升
俯首帖耳	唯命是听	敬谨如命	深信不疑	百依百顺	言听计从	言听计用	视为心腹	唯命是从
俯首称臣	北面称臣	称臣纳贡
俱收并蓄	兼容并包	兼收并蓄	兼而有之	同时兼备
倍日并行	倍道兼行	倍道兼进	倍道而进
倒凤颠鸾	颠鸾倒凤	鸾颠凤倒
倒台	垮台	完蛋
倒塌	倾圮	坍毁	崩塌	倾圯	崩裂
倒屣相迎	倒屣迎宾
倒履相迎	扫径以待
倒悬之危	倒悬之急	倒悬之苦
倒打一耙	贼喊捉贼	颠倒黑白	扭曲作直	颠倒是非	指鹿为马	混淆视听	混淆黑白	混淆是非	离本趣末	舍本逐末	本末倒置	背本趋末	舍本求末	蝉翼为重，千钧为轻
倒持太阿	倒持泰阿	受人以柄	授人以柄
倒映	反照
倒是	却是
倒置	颠倒
倒置干戈	倒载干戈
倒背如流	滚瓜烂熟	驾轻就熟
倒退腐败	凋落	凋谢	凋谢脱落	凋零	干枯	干涸	开放	枯槁	枯竭	枯萎死亡	残落	落莫	雕残	零落凋落
倒闭	开张
倘使	倘若	借使	借使倘使	假使	假若
候鸟	留鸟
倚门卖俏	倚门卖笑
借主	债主	债户
借古喻今	借古讽今	古为今用	援古证今	指桑骂槐	指猪骂狗	指鸡骂狗	含沙射影	含血喷人	恶语中伤	血口喷人	拐弯抹脚	拐弯抹角	旁敲侧击	暗箭伤人	架词诬控	以古为鉴	以古喻今	以古讽今	以古非今	指鸡为狗	出言无状	恶语伤人	出口伤人	出言不逊	恶言恶语	赤口毒舌
借居	寄居	旅居
借据	欠据
借故	借端	托故	藉端
借贷	假贷
借酒浇愁	借酒消愁
倡寮	妓院
倡条冶叶	闲花野草
倩女离魂	离魂倩女
债务	债权
债多不愁	虱多不痒
倾吐	倾诉
倾听	谛听	凝听	聆听	细听
倾尽国库	悉索敝赋
倾心吐胆	开诚相见	开诚布公	待人以诚	推襟送抱	推诚相见	肝胆相照	襟怀坦白	推心置腹	赤诚待人	披肝沥胆	肝胆照人
倾注	倾泻	泼洒
倾盆	滂沱	滂湃
倾盆大雨	滂沱大雨
倾盖之交	倾盖定交	倾盖论交	车笠之盟
倾筐倒庋	倾筐倒箧	倾箱倒箧
倾耳细听	洗耳恭听
倾肠倒笼	翻箱倒柜	翻箱倒箧
倾覆	推翻	颠覆
倾轧	排击	排挤	排斥	接收
偃武修文	放牛归马
偃蹇困穷	命运坎坷	命途坎坷	穷途潦倒
假冒	冒充	混充
假名	化名
假寓	定居
假想	构思	构想	设想	想象
假戏真做	弄假成真
假日	沐日
假相	原形	实情	本相	真相
假称	托辞	遁辞	借口	捏词	设词	设辞
假话	大话	诳言	谎言	谎话	谣言	鬼话
假货	赝品
假造	编造	捏造	虚拟	虚构	假意周旋	虚与委蛇	敷衍了事	虚应故事	虚情假意
假门假事	假门假氏
偏僻	偏疼	偏远	僻静	荒僻冷僻
偏听偏言	偏听则暗
偏袒	左袒
偏见	成见	私见
偏言	曲说
偕行	同业	同行
做作	造作
做工	唱工
做生意	经商
停学	辍学
停工	歇工	罢工
停息	停留	停顿	平息
停歇	勾留	搁浅	暂停	逗留
停步	留步
停泊	停靠
停滞	窒碍	阻滞	障碍
停滞不前	畏缩不前	踌躇不前	因循守旧	墨守成规	抱残守缺	按部就班	故步自封	陈陈相因	裹足不前	闭关自守	闭关锁国	闭门谢客	作茧自缚	玩火自焚	作法自毙	多行不义必自毙	自食其果
停笔	搁笔
停车	泊车
健忘	忘掉	忘记	遗忘	遗记
健旺	强健	强壮	矫健
偶一为之	逢场作戏	蜻蜓点水	游戏人间	抛头露面	粉墨登场	袍笏登场	走马上任
偶合	巧合
偶尔	偶然	无心	无意	有时	间或
偶然性	必然性
偷偷的	悄悄的
偷合取容	偷合苟容
偷安	苟安
偷换	掉包
偷盗	盗窃	偷窃
偷窥	窃看	窃视
偷袭	狙击
偷香窃玉	坠入情网	寻花问柳	窃玉偷香	拈花惹草	迷花沾草
傅粉何郎	面如傅粉	面如冠玉
傍友	清客
傍晚	薄暮	黄昏
傍柳随花	傍花随柳
傍边	当中
傍门	旁门	歪路
储藏	蕴藏	储备	储蓄	贮备	贮藏	储存	堆集	沉淀	积储	积压	积存	积攒	积淀	积累	积聚	积蓄	积贮	蓄积	蕴蓄	贮存
催促	敦促	督促
催讨	追讨
傲岸	立崖岸
傲慢不逊	傲慢少礼	傲慢无礼	傲睨	渺视	傲世轻物	傲睨一世	傲睨万物	傲睨一切	傲睨自若	目空一切	自高自大	恃才傲物	矜才使气
傲骨嶙嶙	铁骨铮铮
傻人有傻福	天公疼核
傻里傻气	笨头笨脑	愚不可及	愚昧无知	无知无识	蒙昧无知	冥顽不灵
像模像样	有模有样	郑重其事
僧人	和尚
僧衣	法衣	袈裟
僵硬	生硬
僻事	僻典
僻处一方	局促一隅
僻巷	穷巷	陋巷
儒教	孔教
儿女	后代	后辈	子女	子弟
儿歌	童谣
允承	慨诺
允文允武	出将入相	文武双全	能文能武	才兼文武	文韬武略	大智大勇	智勇双全	有勇有谋	骁勇善战
元凶	首恶
元勋	功臣
元旦	大年节	除夕
元配	德配
元配夫妻	结发夫妻
兄弟相斗	豆箕相煎
兄弟阋墙	骨肉相残	同室操戈	煮豆燃萁	自相残杀	自相鱼肉	煮荳燃萁	相煎何急
充任	充当
充公	没收
充军	放逐	流放
充排场	撑场面
充数	凑数
充斥	充溢	充满	布满
充饥	果腹
先兆	前兆
先入为主	先入之见	先来后到
先哲	前贤
先声夺人	先斩后奏	先斩后闻	先礼后兵	兵贵先声
先天	天赋
先天不足	后天不良
先意承志	先意承旨
先生	师长	教师
先睹为快	近水楼台	近水楼台先得月	靠山吃山	靠水吃水
先觉	预言家
先锋	前锋
先驱	前驱	先人	祖先
光临	光顾	惠顾	赐顾
光华	名誉	声誉	荣誉
光复	回复复兴	恢复	规复
光天化日	青天白日	众目睽睽	有目共睹	公共场所	公开场合	大庭广众	稠人广众	众目昭彰
光头	秃头	秃顶
光宗耀祖	荣宗耀祖	显亲扬名	光前裕后	耀祖光宗	造福后代
光彩夺目	光芒耀眼	鲜艳夺目	光焰万丈	光芒万丈	光辉灿烂	灿烂辉煌	色彩鲜明
光怪陆离	斑驳陆离	陆离光怪	陆离斑驳	千奇百怪	五光十色	五彩缤纷	五颜六色	花团锦簇	旷古奇闻	不拘一格	形形色色	丰富多采	五花八门	琳琅满目	一应俱全	应有尽有	面面俱到	八门五花
光明	灼烁
光显	鲜明	光鲜	显明	鲜亮
光棍	王老五骗子
光泽	光线
光溜溜	光秃秃	赤裸裸
光滑油滑	圆通
光耀	光芒	光辉	宏放	宽大旷达	明亮	毫光	灿烂	璀璨	绚烂	豁亮	豪爽	辉煌	辉煌光耀	开阔	晴朗	清明	爽朗	鲜丽
光耀门第	光裕大业	克绍箕裘	扬名显亲
光脚	赤脚
光荣	庆幸	光彩	色泽	荣耀
光说不做	光说不练	言而不行
光阴	功夫	工夫	时间	时光	韶光	时候	时刻	时辰
光阴似苒	斗转星移	物转星移
光鲜明显	明显	显着	显著
克制	控制	节制
克意	锐意
克扣	剥削	抽剥	盘剥	聚敛
免却	省掉
免得	省得
免罪	赦罪
免职	夺职	撤职	罢免	罢职	除名	革职
免除	罢黜
兔死狐悲	物伤其类	芝焚蕙叹
兔脱	叛逃	潜逃	逃窜
兔起凫举	兔起鹘落
党同伐异	标同伐异	诛锄异己	沆瀣一气	通合一气	通同一气	朋比为奸	狐群狗党	狼狈为奸	通同作恶	结私营党	诛除异己	打得火热	打成一片	抱成一团
党羽	同党	翅膀
党首	党魁
兜售	兜销	抛售
兜揽	招徕
入伍	退伍
入列	出列
入口	进口
入国问俗	入境问禁
入境	出境
入夜	天黑
入学	退学
入寇	犯境
入席	离席	退席
入木三分	力透纸背	鞭辟入里	切中要害	鞭辟近里	切中时弊	切中时病	一针见血	提纲契领	言必有中	一语破的	一语道破	刀刀见血	单刀直入	开门见山	大笔如椽	正中要害	笔力千钧	铁画银钩
入款	进款
入罪	定罪	治罪	科罪
入迷	出神
入院	出院
全副	全部	悉数	所有
全年	整年
全心	经心
全愈	康复	病愈	痊可	痊愈
全数	扫数
全日	整日
全智全能	全能全智
全球	寰球
全集	选集
全靠	端赖
全面	周全
八九不离十	相差无几	不相上下	大同小异	不分轩轾	不分高低	势均力敌	工力悉敌	旗鼓相当	不分胜负	平分秋色
八仙过海	各显其能
八仙过海，各显其能	八仙过海，各显神通
八公山上，草木皆兵	惊愕失色
八字帖	发草帖
八字没一撇	八字没见一撇
八怪七喇	稀奇古怪	千奇百怪	奇形怪状	天方夜谭	离奇古怪	无稽之谈	挟山超海
八拜为交	八拜之交	金兰之好
八棍子撂不着	八竿子打不着
八珍玉食	山珍海味	山珍海错	山肴野蔌	美味佳肴	龙肝豹胆
八百壮士	四行孤军
八百孤寒	白衣秀士	布衣韦带
八股	陈腔滥调
八面圆通	八面莹澈
八音遏密	遏密八音
公不离婆	唇不离腮	秤不离砣
公事	公务	私事
公价	官价
公众	公共	公家	大众	民众	群众
公例	公则	通则
公允	公平	公正	公道	偏幸	偏心	偏爱
公函	公文	公牍	文移
公判	公审
公子	公子哥儿	膏粱子弟	令郎	混世魔王	纨绔子弟	花花公子	不肖子孙	千金之子	后继无人
公子王孙	纨子弟	纨绔子弟	膏粱子弟	花花公子
公差	公役
公平合理	公道合理
公开	公然	地下	悍然
公德	私德
公心	私心
公报私仇	挟私报复
公断	公评
公有	私有
公正廉洁	清正廉洁
公民	国民	庶民	百姓	苍生	黎民
公理	朴重	正义	正大	正派	正直	端方	端正	耿直	规矩	公法	划定	功令	司法	律例	法令	法例	法则	法规	王法	纪律	规则	规定	规律	轨则	国法	执法
公约	条约	合同
公营	国营
公证人	评判人
公费	自费
公馆	私邸	第宅
六趣轮回	六道轮回
兰摧玉折	哲人其萎	香消玉陨
兰桂齐芳	椿萱并茂
兰艾俱焚	玉石同烬
共事	同事
共同	配合	合营
共同努力	通力合作	合情合理	逼上梁山	通情达理	情有可原	惬心贵当	无可非议
共计	合计	算计
共识	共鸣
共谋	合谋	同谋
关上	打开	掀开	翻开
关口	关隘	环节
关头	关键	枢纽	要害
关山迢递	千里迢迢	不远万里	不远千里	天南海北	地角天涯	天各一方	天涯海角	路远迢迢
关心	关怀	体谅	体贴	谅解
关注	存眷
关照	呈报	呈文	告诉	报告	敷陈	申报	讲演	讲述	述说	通知	陈诉	陈说	陈述
关系	关连	干系	相干	相关
关联	联系关系
关节	枢纽关头
关门落锁	闭门塞窦
关门落闩	盖棺论定	盖棺定论
关闭	封锁	封闭	敞开	洞开
兴修	兴建
兴兵	兴师	出兵	发兵
兴办	创办	开办
兴师动众	穷兵黩武	大兴土木	鸠工庀材	黩武穷兵
兴废	荣枯
兴旺发达	枝叶扶疏	枝繁叶茂	生机勃勃1
兴盛	昌盛	繁荣	兴旺	兴隆	旺盛	昌隆	郁勃	隆盛	发家	发财	发达
兴起	鼓起
兵不厌权	兵不厌诈	兵行诡道	纵横捭阖	远交近攻
兵书	兵法
兵出无名	师出无名	平白无故	无缘无故	事出有因	义正辞严	名正言顺	振振有词	理所当然	理直气壮	顺理成章
兵出有名	师出有名
兵力	军力
兵变	叛乱
兵器	刀兵	火器	武器
兵在其颈	兵已在颈
兵士	战士
兵微将寡	将寡兵微
兵戈扰攘	兵戈抢攘
兵无常势	兵无常形
兵来将挡，水来土掩	兵来将敌，水来土堰
兵种	军种
兵舰	军舰
兵荒马乱	兵连祸结	内忧外患	天下大乱	鸡犬不宁	兵慌马乱
兵马	戎马
其中	此中	个中
其余	其它	别的	另外	此外	其他
其后	厥后
其实	切实	卡脖子	实在	恰谈	洽商	洽谈	着实	确切	适当
其时	当时	事先	事后	过后	那时	预先
典丽矞皇	典雅堂皇
典押铺	解当铺
典籍	文籍
典质	抵押
养分	营养
养成工	练习生
养生	摄生
养生送死	养老送终
养虎遗患	放虎归山	养痈成患	养痈遗患	养虎伤身	姑息养奸	放龙入海	养虎为患	养痈贻患	后患无穷	祸不单行	纵虎归山	贻害无穷	遗患无穷	遗祸无穷
兼听则明，偏信则暗	兼听则明，偏听则暗
兼并	合并	归并	吞并
冀望	期望	盼愿	盼望	祈望	指望
冁然一笑	冁然而笑
内中	内里
内乱	内争	内哄
内人	贤内助	内子	浑家
内在	内涵	外延
内外	表里
内外夹攻	里应外合	内外勾结	里勾外连	里通外国	卖国求荣
内室	阁房	闺房	闺阁
内幕	内情	底子	底细	秘闻	黑幕
内心	心坎	心田	心里
内疚	汗下	汗颜
内省	自察
内耗	内讧
册封	封爵
再会	再见
再作冯妇	重操旧业
再娶	另娶
再版	重版
再醮	改嫁
冒大不韪	冒天下之大不韪
冒失鬼	失魂鱼
冒昧	造次
冒死	拚命	拼死	搏命
冒犯	开罪	得罪	获咎	触犯
冗杂	繁冗	繁杂
冗赋	杂税
写意	适意
军书	羽书
军事机密	戎机
军人	武士
军令如山	号令如山
军功	战功
军号	号角
军备	武备
军师	智囊
军装	戎衣
军队	步队	部队	队伍
农事	稼穑
农人	农夫	农民
农具	耕具
农历	夏历	阴历
农家	田舍
农家子	田舍郎
农户	庄家
农歌	村歌	牧歌
冠冕堂皇	堂而皇之
冤各有头，债各有主	冤有头，债有主
冤家债主	怨家债主
冤家对头	对头冤家
冤屈	冤枉	始末	委屈	委曲
冥具	冥器	明器
冥思苦索	瞑思苦想
冥行擿埴	暗中探索
冬烘	腐儒
冬衣	寒衣
冬风	北风	寒风
冰冻三尺，非一日之寒	滴水穿石	铁杵磨针
冰天雪地	冰天雪窖	滴水成冰	雪窖冰天	千里冰封	天寒地冻
冰片	龙脑
冰肌雪肠	冰魂雪魄
冰脸	冷面
冲入	突入	闯入
冲凉	洗沐
冲击	打击	攻击	攻打	袭击	进击	进攻	进犯	突击	侵占	侵扰	侵犯	侵略	侵陵	加害	强占	扰乱	陵犯	骚动扰攘侵犯
冲刷	冲洗
冲垮	冲毁
冲天大火	火势燎原	燎原之势	燎原烈火
冲弱	幼稚	稚嫩	稚子	童稚	老练
冲撞	抵触	触犯
冲破	打破	突破
冲突	抵触
冲要	要冲
决不后退	车无退表
决战苦战	血战
决断如流	应付裕如	应付自如	游刃有余	胜任愉快	运斤如风	运斤成风	从容不迫	措置裕如
决死	殊死
决然	决然毅然	断然	毅然
决绝	复交	断交	绝交
决计	决议确定	定夺
决雌雄	分高下	定胜败
冶叶倡条	野草闲花
冶坊	炼坊
冶游	嫖妓
冷光	寒光
冷冷清清	熙熙攘攘	摩肩接踵	熙来攘往	水泄不通	风雨不透	人山人海	比肩接踵	比肩继踵
冷嘲热讽	冷嘲热骂	冷言冷语	冷语冰人	反唇相稽	反唇相讥	嬉笑怒骂	讽刺挖苦
冷天	寒天
冷害	寒害
冷巷	小巷
冷战	暗斗
冷暖自知	心里有数
冷气	寒气
冷汗	盗汗
冷淡	冷漠	淡漠	淡薄	稀薄	不搭理	冷落	浓厚	浓密	浓烈	浓郁	浓重	稠密	粘稠	奇丽	奇异	奇怪	奇特	希奇	独特	稀少	稀疏	稀罕	怪异
冷笑	取笑	嗤笑	嘲笑	嘲讽	打诨	挖苦	耻笑	讥刺	讥嘲	讥笑	讥诮	讪笑	讽刺	奚弄	讥讽	调侃
冷箭	暗箭
冷飕飕	暖烘烘
净化	污染
凄凉	凄惨	悲凉	悲惨	苍凉	苦楚	凄切	悲凄	楚切	惨痛
凄怆	惨怆	惨恻
凄风苦雨	腥风血雨	苦雨凄风	风雨如晦	风雨如磐	血流成川	血流成河	血流成渠	血流如注	血流漂杵	血雨腥风	尸横遍野	血肉横飞
准假	给假
准则	准绳	原则
准备	操办	筹办	筹备	预备
准时	守时	定时	按时
准期	如期
准确	正确	精确
凉帽	草帽
凉快	风凉
凋射	溃烂	糜烂	腐化	腐朽	腐烂	腐臭	腐败	陈旧迂腐	靡烂
凌驾	横跨	超出跨越	超过跨过	高出
减产	增产
减价	削价	涨价	落价	贬价	跌价	降价
减刑	弛刑
减员	增员
减弱	削弱
减色	增色	逊色
减轻	加重
凑巧	恰巧	可巧	碰劲	碰巧
凑数其间	碌碌无为	平庸无奇	无所作为	樗栎庸材	碌碌无能	寻欢作乐	寻花问柳	弄柳拈花	拈花惹草	斗鸡走狗	无所事事	闲韵野鹤	游手好闲
凑趣儿	奉迎	市欢	讨好
凑近	靠近
凝固	凝结	凝聚	凝集	固结
凝思	凝神
凝滞	呆板	呆滞	机器	板滞	机械
凝视	谛视	凝望	凝睇	注视依草附木
几何	几多	几许	多少	好多	若干	很多多少
凡人	常人
凭单	笔据
凯旅	出师	班师
凶兆	恶兆
凶年	歉岁	荒年
凶服	孝服
凶相	恶相
凶讯	噩耗	凶信
凶险	凶恶	凶暴	凶狠	凶猛	残忍	泼辣	阴险	严酷	凶横	恶毒	惨酷	暴虐	歹毒	残暴	残酷	毒辣	狠毒	凶悍	桀	凶残	横暴
凸起	突出
凹地	洼地
出世	出生	出生避世	入世
出世超凡	超凡出世
出书	出版
出事	失事	误事出事
出于无奈	必不得已	迫不得已	何乐不为	心甘情愿	无可奈何	毫不勉强	不可奈何	无可奈何花落去	百般无奈
出入	收支	进出
出凡入胜	超凡入胜
出击	反击	回击	回手	还击
出力	着力
出力异常	特别卖力
出发	动身	启碇	启航	开航	登程	解缆	起程	启程
出发点	起点
出名	有名	着名	知名	著名	闻名	驰名	驰誉
出售	发售
出场	进场
出头具名	出面
出头露面	抛头露面	初生牛犊	头角峥嵘	高人一等	出人头地	不甘寂寞	不甘示弱	初试锋芒	初露锋芒	崭露头角	初露头角	声誉鹤起	身价百倍	高人一筹	声价十倍	声价百倍
出奔	出走
出家	落发	还俗
出工	收工
出席	列席	缺席
出息	前程	长进	上进	出路	前途
出没无定	行踪飘忽
出没无常	神出鬼没	神妙莫测	诡秘莫测	变化多端	波谲云诡	难以捉摸	变化不测	变化无常	变化莫测	按兵不动	变幻	幻化	千变万化	变化无穷	变幻无穷	变幻莫测	瞬息万变	变幻无常	奥妙无穷	风云变幻	鬼出电入	鬼出神入
出洋	放洋
出漏洞	露马脚
出生入死	枪林弹雨	身经百战	不避水火	不避汤火	冲锋陷阵	舍生忘死	赴汤蹈火	摧锋陷坚	摧锋陷阵	奋不顾身	万死不辞	不避斧钺	视死如归	南征北战	卑恭屈节	卑躬屈膝	历尽艰险	大义凛然	奴颜婢膝	奴颜婢色	奴颜媚骨	宁为玉碎	粉身碎骨	肝脑涂地	冲坚毁锐	东征西讨
出神入化	炉火纯青
出缺	有缺
出航	返航
出色	超卓
出谋划策	出谋献策
出身	身世
出错	失足	犯错
出险	脱险	遇险
出顶	召盘
击中要害	拊背扼吭	拊背扼喉	一语破的	言不虚发	言必有中
击柝	打更
函牍	尺书	尺牍	尺简	尺素
刀上超生	刀下留人	刀下留情
刀口上舔血	刀头舔血
刀笔	词讼
刀耕火种	刀耕火耨	火耨刀耕	火耕水种	火耕水耨	火耕流种
刀锯不辞	死生无惧
刁滑	刁猾	奸巧	奸滑	奸诈	奸险	尖利	尖锐	巧诈	锋利	锐利	险诈
刁狡	机诈
刁话	蛮话
分列	布列	排列	陈列	摆列	罗列	胪列	铺排	陈设
分别辨别	分辨差别
分化	分解	合成	声名	声明	申明	说明	分析	剖析	阐发	阐明	对面	解析
分发	披发	散发
分家	分居	分炊	分爨
分崩离析	土崩瓦解	豆剖瓜分	不可救药	无可救药	病入膏肓	不可收拾	不治之症	气息奄奄	内外交困	头破血流	烂额焦头	焦头烂额	狼狈不堪	一败涂地	溃不成军	桑落瓦解
分布	散布	漫衍
分开	分隔	分隔隔离分散
分形共气	分形同气	分形连气
分成	分红
分担	分管
分拨	分派	分配	调配
分文不值	分文不直	毫无价值
分明	清楚	清亮	清晰	清澈
分泌	排泄	渗出
分流	干流	支流
分茅列土	分茅裂土
分说	分辨	分辩	划分	判袂	区分	辨别	辩白	辩解	鉴别	鉴识
分身不暇	分身乏术
分量	重量
分门别类	比物连类
切切私语	喁喁私语
切口	暗语	瘦语	隐语
切断	堵截	割断
切肤之痛	切身痛苦	剥肤之痛	同感身受	痛定思痛
切脉	把脉	评脉
切谏	直谏
切题	贴题
刊定	改定
刊心刻骨	铭心刻骨	沦浃肌髓	沦肌浃髓	刻骨铭心	铭心镂骨	镂骨铭心	镌骨铭心	永志不忘	没齿不忘	刻肌刻骨	刻骨镂心	寤寐思之	念兹在兹	念念不忘	昼思夜想	朝思暮想
刊登	登载
刑场	法场
刑罚	科罚
划子	小船
划船	荡舟
列位	各位
列功覆过	将功补过	以功补过	将功折罪	将功赎罪	戴罪立功	改邪归正	立功赎罪
列国	各国
列土分茅	裂土分茅
刚刚	刚才	方才	适才
刚劲	刚毅	坚毅
刚好	恰好	恰恰	正好
刚巧	正巧	适值
刚强	坚定
刚愎自用	我行我素	深闭固拒	深闭固距	自以为是	一意孤行	不伏烧埋	不可理喻	固执己见	死心塌地	顽固不化	以意为之	独断独行	独断专行	独行其是	个性难改	本性难移	依然故我	故态复萌	积习难改	积重难返
创作	创造	制品	发明	发现	成品	缔造
创建	创立	建立
创新	立异	翻新
初一	月朔
初出茅庐	新官上任	新硎初试	下车伊始	新来乍到	下车之始	削铁如泥	吹发可断	新发于硎	人生地疏	初生牛犊
初创	始创	草创	创始	首创	开创
初度	初次	首次
初志	初衷
初春	早春
初月	眉月
初版	第一版
初生牛犊不怕虎	敢作敢为	无所畏惧	敢作敢当	敢做敢当	临危不惧	无私无畏	视死如归	傲雪凌霜	傲雪欺霜	傲霜斗雪	战天斗地	坚贞不屈	乳犊不怕虎	初生之犊	初生之犊不怕虎
初稿	底稿	稿本	草稿
初赛	预赛
删改	改削	点窜	编削	修改	修正	批改
删省	删节
判决	裁决	讯断
判定	断定	剖断	鉴定
判词	判语
判辨	剖判	剖释	别析	剖别	剖辨
利害	好坏	诟谇	黑白	优劣
利市三倍	获利优厚
利益均沾	独享权益
别传	外传
别具肺肠	别有肺肠	另有所图	别有心肝	别有心肠	别有用心	深加隐讳	讳莫如深	闪烁其词	不可告人	包藏祸心	居心叵测	心怀叵测	存心不良	醉翁之意
别史	外史	野史
别号	别名	又名
别抱琵琶	琵琶别抱	移情别恋
别无二致	完全一致
别有风味	别饶风趣	地方风味	家乡风味	拔新领异	标新立异	别具一格	别出心裁	别出新意	别出机杼	别开生面	独出心裁	不落俗套	与众不同
别鹤孤鸾	别鹤离鸾
刮目相待	拭目以待	静观其变
刮目相看	另眼相看	另眼看待	厚彼薄此	厚此薄彼	另眼相待	薄彼厚此	柔茹刚吐	欺软怕硬	畏强欺弱	重富欺贫	一视同仁	同日而语	混为一谈	相提并论	等量齐观	视同一律
刮风	起风
到临	惠临	来临	莅临	降临
到任	就任
到场	加入	参加	插足	介入	列入	参与	参预	染指	问鼎
到处	各处	四处	处处	遍地	随处
到处为家	四海为家	断梗飘萍	浪迹天涯	远走高飞	妻离子散	流离失所	离乡背井	背井离乡	荡析离居	颠沛流离	家破人亡	骨肉分离	骨肉离散
到处颂扬	脍炙人口	喜闻乐见	喜闻乐道	交口称誉	有口皆碑	爱不释手	雅俗共赏
到家	抵家
到差	履新	接事	赴任
到底	究竟	最后	最终	终极
到手	得手
到达	抵达	达到
制作	制造	建造	造就
制度	轨制	制定	制订	拟定
刷洗	洗擦
刹时	瞬时	瞬间
刺刺不休	唠唠叨叨	一长一短	口角生风	嘘枯吹生	能说会道	贫嘴薄舌	贫嘴贱舌
刺探	打探	探听	密查
刺目	刺目耀眼	刺眼	扎眼	耀眼	夺目	精明	醒目	无能	炫目	能干
刺股悬梁	悬梁刺骨	秉烛夜读	好学不倦	昼耕夜诵	手不释卷	百读不厌	百闻不厌	如获至宝	爱不忍释	爱不释手	学而不厌	虚心好学	白首穷经	皓首穷经	老当益壮
刺骨	澈骨	砭骨	彻骨	透骨
刻下	此刻	此时	目下	眼前	而今	面前	面前目今
刻日	期限	限日	限期
刻木为吏	削木为吏
刻舟求剑	胶柱调瑟	胶柱鼓瑟
刻苦	受苦
刻鹄类鹜	画虎成犬	画虎类犬
刿心怵目	刿目怵心	触目惊心	怵目惊心	惊心动魄	动魄惊心	胆战心寒	胆战心惊	胆颤心惊	面无人色	惊惶失措	惶恐不安	诚惶诚恐
剃头	剪发	理发
削发为僧	遁入空门	遁迹空门
削足就履	截趾适履	截趾适屦	削足适履	如法泡制	照猫画虎	依样画葫芦	依模画样	刖趾适履	杀头便冠	生搬硬套	如法炮制	照本宣科	照葫芦画瓢
前世	前生	宿世
前世怨仇	夙世冤家
前事不忘	后事之师
前人修路后人行	前人栽树，后人乘凉
前任	后任
前去	前往
前后相接	肩摩踵接	挨肩接踵
前夕	前夜
前度刘郎	重作冯妇
前怕狼	后怕虎
前思后想	忖前思后
前所未闻	旷古未闻	前所未有	前无古人	史无前例	见所未见	开天辟地	空前绝后	亘古未有	屈指可数	比比皆是	空前未有	触目皆是
前提	条件
前方	后方	前线	火线	前列	前哨
前景	近景
前期	后期
前程似锦	康庄大道	阳关大道
前进	行进	进步
前途似锦	鹏程万里	万里鹏程	不可限量	前途无量	来日方长
前途难料	未定之天
前门去虎，后门进狼	前门拒虎，后门进狼	顾此失彼	左支右绌	捉襟见肘	掣襟肘见	掣襟露肘	衣冠楚楚	衣衫褴褛	东扶西倒	剜肉补疮	挖肉补疮	百孔千疮	衣不蔽体	破衣烂衫
剑头一吷	剑首一吷
剖明	标明	注解	表明	表白	表达	解释	讲明	评释
剖白	辨白
剖解	解剖
剥削者	吸血虫
剥夺	褫夺
剥床以肤	剥床及肤
剥极必复	否极必泰	枯木逢春	旱苗得雨	暗室逢灯	绝渡逢舟	雪中送炭	枯木生花	枯树开花	枯树生花	绝处逢生	死里逃生	虎口余生	起死回生	转危为安	逢凶化吉	遇难成祥
剥皮抽筋	抽筋剥皮
剥肤椎髓	剥肤锥髓
剥茧抽丝	披沙拣金	顺藤摸瓜	去芜存菁	排沙简金	沙里淘金	去伪存真	去粗取精	澄沙汰砾	本来面目
剧场	戏院
剧烈	强烈	激烈	猛烈
剧盗	大贼
剪烛西窗	同窗夜语	西窗剪烛
副作用	反作用
副册	正册
副品	正品
副角	配角
割席分座	管宁割席
割肉医疮	望梅止渴	画饼充饥	聊以自娱	聊以自慰	聊以解嘲
割肚牵肠	牵肠挂肚	念念不忘	耿耿于心	耿耿于怀	铭心镂骨	朝思暮想	红豆相思	梦寐以求	心心念念	念兹在兹	没齿难忘
剽悍	慓悍
剽窃	抄袭
剿抚兼施	德威并用	恩威并重
剿袭	袭取
劈叉	劈腿
劈头	劈头劈脸	劈脸	匹面
劈面	当面	扑面	歼灭	毁灭	迎面	扑灭	消灭	点燃	覆灭	息灭	杀绝	袪除	没落	败落	祛除	破落
力不能支	绵力薄才	缚鸡之力
力争上游	取法乎上	见德思齐	见贤思齐	再接再厉	知难而进	夜以继日	快马加鞭	马不停蹄	马不解鞍	发愤图强	奋发图强	奋发有为	奋发自强	奋发蹈厉	蹈厉奋发	中流击楫	励精图治	雄才大略	卧薪尝胆	自强不息	艰苦创业	艰苦奋斗	宏才大略	经天纬地
力尽筋疲	筋疲力尽	心力交瘁	筋疲力竭	精疲力竭	身心交瘁	神采飞扬	精神焕发	有气无力	神采奕奕	精神奕奕	疲惫不堪	精疲力尽
力所不及	敬谢不敏	无能为力	鞭长莫及	一唱一和	遥相呼应	一拍即合	一见倾心	亦步亦趋	心心相印	情投意合	一呼百应	两两相对	遥遥相对	遥遥相望	来者不善	来者不善，善者不来	其应若响	一呼百诺	八方呼应	前呼后应	前呼后拥	一倡百和	响应风从	应者云集
力挽狂澜	持危扶颠
力竭声嘶	声嘶力竭	大喊大叫	大声疾呼	大吵大闹	大呼小叫	摇唇鼓舌	轩然大波
劝告	劝说	奉劝	挽劝	劝戒	规劝
劝善	惩恶
劝导	疏导	疏浚	沟通	疏通
劝止	劝阻
劝诫	告诫	申饬	警告	使令	差遣	驱使	驱策	吩咐	派遣	调派	丁宁	交托	付托	叮咛	叮嘱	打发
办好	办妥	搞妥
办理	治理	牵制	管制	管教	管束	管理	经管	打点	拾掇	摒挡	操持	收拾	料理	解决
功劳	功勋	功烈	功绩	劳绩	勋绩
功势	守势
功名利禄	富贵荣华	家财万贯	富可敌国	富埒王侯	富埒陶白	富堪敌国	富有天下	鲜衣美食	腰缠万贯	身无分文	万贯家财	家赀巨万	积玉堆金	肥马轻裘	财大气粗
功在不舍	勤能补拙	将勤补拙
功成身退	知难而退	半途而废	废然而返	打退堂鼓	畏缩不前	虚此一行	败兴而归	鸣金收兵	鸣金收军
功能	性能	机能	功效	功用	效率	效用
加倍	愈加	更加	越发
加强	增强
加快	加速	放慢
加添	填充	添补
务去陈言	陈言务去
务实	求实
劣行	败行
劣货	次货
动乱	动荡	骚动	纷扰
动人心魄	扣人心弦	令人震惊	勾魂摄魄	荡气回肠	回肠荡气	如泣如诉	沁人肺腑	感人肺腑	动人心弦	沁人心脾	荡人心腑
动人肺腑	感人心曲	沁人心脾	沁人肺腑
动力	能源
动向	意向
动听	入耳	动人	悦耳	感人	中听	顺耳
动员	发动	发起	带动	倡导	提倡	首倡	倡议	创议	建议	提议
动工	开工
动弹	滚动	转动	转折	迁移转变	起色	转机
动态	动静	静态	新闻	消息	音讯
动怒	息怒	起火	心照不宣	得意忘言
动机	念头
动辄得咎	跋前踬后	左右为难	羝羊触藩	进退两难	进退维谷	不尴不尬	势成骑虎	骑虎难下
助势	助威	助长	滋生
助长声势	呐喊助威	摇旗呐喊	擂鼓助威	鸣锣喝道	鸣锣开道
努目	怒视	瞪眼
劫后余生	大难不死
劫持	威胁	挟制	要挟
劲头	干劲
劲敌	强敌
劳心焦思	苦思苦想
劳燕分飞	鸾凤分飞	烟消火灭	风流云散	生离死别	分道扬镳	各奔前程	分路扬镳
劳神	操心	费心	费神
劳累	操劳	辛苦
势不可当	当者披靡	势如破竹	所向披靡	锐不可当	不败之地	所向无敌	百战百胜	长驱直入	一挥而就	一气呵成	一鼓作气	下笔千言	不蔓不枝	文从字顺	珠圆玉润	趁热打铁
势力	权势
势如水火	积不相容
势如骑虎	握蛇骑虎
勃然变色	怫然作色
勇士	壮士
勇敢	大胆	斗胆	斗胆勇敢	果敢	怯懦	英勇	勇冠三军	勇者无惧	勇猛	骁勇	勇于	敢于
勇而无谋	愣头愣脑	有勇无谋	呆头呆脑	愣头磕脑	木头木脑
勉为其难	强人所难	强奸民意	强按牛头
勉强	屈身
勒索	打单
勒迫	胁迫	钳制
募捐	捐献
募集	召募
勤勤俭俭	艰苦朴素	克勤克俭	勤俭节约	省吃俭用	坚苦卓绝	艰苦卓绝	奋发图强	自力更生	艰苦创业	艰苦奋斗
勤奋	怠惰	怠懈	懈怠	勤劳	勤勉	用功	懒惰
勤学	好学
勤苦	发奋	发愤	奋发	奋斗	振奋	立志
勾勒	勾画革新	鼎新
勾栏	北里	娼寮
勾消	抹煞
勾肩搭背	挨肩搭背	挨肩擦脸
勾销	取消	打消	撤销	消除	作废	消弭
匀称	均匀	平均
包办	包揽	承办	经办
包含	蕴含
包围	包抄	困绕	围困	笼罩
包容	包涵	原谅	海涵	留情	见原	见谅	容纳	包罗万象	面面俱到	面面皆到	无所不包	无所不有	应有尽有	无奇不有	一应俱全	包含	包孕	包括	包罗	搜罗
包庇	容隐	偏护	卵翼	回护	庇护	护卫	维护	保护	掩护	呵护	垂怜	怜爱	爱怜	爱惜	爱护	爱护保重	珍惜	珍爱	顾惜
包羞忍耻	包羞忍辱
包袱	承当	承担	担负	肩负	负担	承受	承继	承袭	担任	担当	持续	接受	秉承	经受	继承	继续	负责
匆忙	慌忙
匍匐	爬行	膝行	蒲伏	蒲伏爬行
化为乌有	化为泡影	子虚乌有	囊空如洗	室如悬罄	阮囊羞涩	一文不名	一无所取	一无所得	一无所有	一贫如洗	两手空空	功亏一篑	妙手空空	空空如也	身无长物	一无所获	一事无成	一无所成	一无所能	一窍不通	劳而无功	徒劳无益
化解纠纷	和好	和解	息争
化险为夷	转危为安	转败为功	变危为安	反败为胜	扭转乾坤	转败为胜	绝处逢生	转灾为福	转祸为福	转败为成
北斗	斗极
北门之管	北门锁钥
北门南牙	文武百官
匡乱反正	拨乱反正	吊民伐罪	存亡断绝	拨云见天	救亡图存	旋转乾坤	刊谬补缺	补偏救弊	补苴罅漏	补阙拾遗	补阙挂漏
匡正	指正	斧正	示正
匪贼	土匪	匪徒	强盗
匹敌	反抗	对抗	对立	抵制	抵当	抵御	抵抗	抵拒	抵挡	招架
匹马不还	匹马只轮
区区	忽视	戋戋	无视	轻忽
区域	地区	地域
医治	治疗
医生	大夫
医院	病院
十亲九故	沾亲带故	沾亲带友
十分困难	好不容易
十字街头	十字路口
十手所指	千人所指	千夫所指
十指尖尖	皮娇肉嫩
十日	旬日
千万买邻	千钱买邻
千了万当	千了百当	百了千当
千人一面	千篇一律	千部一腔，千人一面	如出一辙	一模一样	陈旧见解	毫无二致
千呼万唤	呼天喊地
千回万转	千回百转
千头万绪	百废待举	百废待兴	百端待举	千端万绪	三头两绪	纷然杂陈	错综复杂	千丝万缕	心如乱麻	盘根错节	牵丝挂藤	空中楼阁	蜃楼海市	扑朔迷离	海市蜃楼	虚无缥缈	子虚乌有	梦幻泡影	虚无飘渺
千姿百态	千态万状	绰约多姿	眉清目秀	眉目如画	眉眼如画	秀外慧中	耳聪目明	千娇百媚	婀娜多姿	花枝招展
千疮百孔	满目疮痍
千般	各式	各样	百般
千载一时	千载难逢	百年不遇	铁树开花	凤毛麟角	稀世之珍	空谷足音	出类拔萃	数一数二	栋梁之材	百里挑一	价值连城	吉光片羽	奇珍异宝	无价之宝	连城之价
千辛万苦	历尽艰辛	含辛茹苦	如牛负重	茹苦含辛	历尽沧桑	饱经风霜	吸风饮露	沐雨栉风
千里之堤	溃于蚁穴
千里之行	始于足下
千里寄鹅毛	千里送鹅毛	千里鹅毛
千里镜	望远镜
千金小姐	大家闺秀	金枝玉叶	闺房之秀
千难万险	山高水险	艰难险阻	坎坷不平	崎岖不平	艰难困苦	艰难曲折	荆棘载途
升值	贬值
升堂入室	造诣高深
升平	升平平安	泰平承平
升引	起用
升沉	崎岖	起伏
升级	晋级	进级
升降	起落
午睡	昼寝
半吐半吞	欲言又止	当机不断	迟疑不决	举棋不定	游移不定	犹豫不决	狐疑不决	首鼠两端	沉吟不决	沉吟未决	踌躇不决	踌躇未决
半推半就	明推暗就	虚情假意	诚心诚意	半真半假	故作姿态	装模作样	假仁假义	假装好人	装疯卖傻	装聋作哑	装腔作势
半数	对折	折半
半新不旧	半新半旧
半晌	片刻	少焉	少顷	片时	片晌	片霎
半生不熟	半生半熟
半老徐娘	残花败柳	徐娘半老
半路出家	半道出家
半身不摄	半身不遂
半部论语	半部论语治天下
半青半黄	青黄不接	后继无人	难以为继
半面之交	半面之旧	一面之交	点头之交	半面不忘	莫逆之交	一面之缘	一面之识	萍水相逢
华侨	华裔
华山	西岳
华文	汉文
华翰	大札	宝缄	朵云
华而不实	质非文是	金玉其外，败絮其中	秀而不实	脆而不坚	虚有其表	大而无当	庞然大物	硕大无朋	败絮其中	金玉其表
华衣美食	鲜衣美食
协力	合力
协定	协议	和谈
协调	和谐	调和	谐和
卑劣手段	阴谋诡计	鬼域伎俩	诡计多端	大智若愚	智谋过人	诡变多端	足智多谋	鬼计多端	深藏若虚	虚怀若谷	谦恭虚己	谦虚谨慎
卑礼厚币	卑辞厚币	卑辞重币	卑辞厚礼	币重言甘
卑视	奴视	贱视	歧视	不放在眼里	蔑视	藐视	轻蔑	轻视	鄙视	小看	漠视	鄙夷	冷视	忽视	无视
卒业	毕业	结业
卓有成效	行之有效	吹糠见米	立杆见影	立竿见影	空谷传声	立见成效	马到成功
卓越	杰出
单位	单元
单子	票据	单据
单方面	片面
单独	独自	零丁
单调	干燥	枯燥	死板	古板
单身	只身	独身
卖儿鬻女	卖男鬻女
卖公营私	损公肥私法律
卖刀买犊	卖剑买牛
卖官卖爵	卖官鬻爵
卖弄风骚	搔首弄姿	搔头弄姿	装腔作势	水性杨花	嬉皮笑脸	打情卖笑	打情骂俏	眉来眼去	涎皮涎脸	涎皮赖脸
卖文为活	笔耕墨耘
南去北来	南来北往	来来往往
南山可移	南山铁案
南方	南边
南柯一梦	白日做梦	黄粱一梦	黄粱美梦	槐南一梦	春梦一场	邯郸一梦	邯郸之梦	一枕槐安	一枕黄梁	痴心妄想	想入非非	游思网箱	胡思乱想	胡思乱量	非分之想	异想天开	谬想天开	炙冰使燥	妙想天开
南郭先生	南郭处士
南风	熏风
博大	博识	宏大辽阔	广博	渊博	精深	赅博
博得	赢得
博爱	泛爱
博硕肥腯	膘肥体壮
博见多闻	博览五车
博览会	展览会
博采众议	博采群议
卜夜卜昼	卜昼卜夜
卤莽	粗鲁
卧室	寝室	睡房
卧薪尝胆	尝胆卧薪	发扬踔厉	发扬蹈厉	意气风发	刻苦自励	发奋图强	发愤图强	自强不息	坐薪悬胆	宵衣旰食	壮志凌云	雄心万丈	斗志昂扬	豪情壮志	望秋先零	未老先衰	老当益壮	老骥伏枥
卫护	戍卫
印子钱	高利贷
危坐	端坐
危害	风险
危峰兀立	怪石嶙峋
危急	危机	求助紧急
危机四伏	四郊多垒	四面楚歌	八方受敌	腹背受敌	八面受敌	山穷水尽	日暮途穷	穷途末路	走投无路	道尽途穷	十面埋伏	表里受敌
即位	登位	登基
即使	即便	纵然	只管	尽管	尽量	诚然
即将	登时	行将	顿时	马上
却之不恭	受之有愧	盛情难却	当之有愧	愧不敢当	担当不起
卵形	椭圆形
卵白	蛋白
卷烟	香烟
卷铺盖	炒鱿鱼
历历可见	历历可辨
历历在目	言犹在耳	记忆犹新	不可多得	汗牛充栋	车载斗量	一清二楚	历历可数	寥寥无几	屈指可数	不可胜数	不计其数	左图右史	浩如烟海	连车平斗
历历如绘	绘声绘影	绘声绘色	绘影绘声	活灵活现	活龙活现	活龙活现	呼之欲出	有声有色2	有血有肉	栩栩如生	活神活现	跃然纸上	宛在目前	维妙维肖
历历落落	清清楚楚	明明白白	清清白白
历史	汗青
历年	积年
历本	通书	黄历
历程	过程	进程
厉世摩钝	厉世磨钝
厉兵秣马	秣马厉兵	练兵秣马
压倒	压服	胜过	说服	赛过
压倒一切	名列前茅	首屈一指	加官进爵	加官进禄	金榜题名	飞黄腾达	蟾宫折桂	金榜挂名
压制	压抑
压榨	压迫	榨取
压缩	紧缩
压肩叠背	挨肩叠背	挨肩并足	挨肩擦背	挨肩擦膀	挨肩迭背
压轴好戏	好酒沉瓮底
厌烦	烦厌	腻烦	讨厌	淘气	调皮	顽皮气焰万丈	狂妄自大	眼空四海
厕所	茅厕	洗手间
厕纸	草纸
厘正	雠正
厘革	变化	革新
厚交	急流勇退	深交	知交	明哲保身	激流勇退	假力于人	假手于人	假公济私	损公肥私	损人利己	自私自利	见死不救
厚利	重利
厚古薄今	慕古薄今	贵远贱近	贵远鄙近
厚礼	薄礼
厚貌深情	外温内厚	厚貌深文	厚貌深辞
厚道	忠实	恳切	老实	诚实	诚心	诚恳	诚笃	赤诚	忠厚	忠诚	热诚	热忱
厚酬	重酬
原因	启事	因由	来由	缘故原由	缘由	起因
原址	旧址
原始要终	追根溯源
原始见终	因小见大	见微知着
原料	材料	质料	资料
原本	本来	正本	原来
原籍	故国	本籍	祖国	祖籍
原野	旷野	田野	郊野	野外
厢房	配房
厮役	苍头
厮混	胡混	鬼混
去处	行止	去向
去头去尾	掐头去尾
去如黄鹤	杳如黄鹤	海底捞针	无影无踪	杳无消息	杳无踪影	杳无音信	泥牛入海	垂手可得	手到擒来	探囊取物	易如反掌	大海捞针	江中钓月	海中捞月	百年不遇	铁树开花
去官	辞官
去年	客岁
去逝	断命	死灭	毕命
参半	各半
参回斗转	深更半夜	三更半夜	黑天半夜	黑更半夜
参差	整洁	整齐
参谋	垂问	照料	顾问
及早	赶早	趁早
及时	实时
及格	合格
及笄年华	豆蔻年华	含苞待放	金色年华	黄花少年	黄金时代
及第	录取	登科	考中	落第
友人	同伙	朋侪	朋友
友好邻邦	礼仪之邦
友邦	盟国
双宿双飞	莲开并蒂	比翼齐飞	比翼双飞	伉俪	凤凰于飞	夫唱妇随	夫妻	琴瑟之好	琴瑟同谐	琴瑟同谱	琴瑟和谐	琴瑟调和	鸾凤和鸣	鹿车共勉	鹿车共挽	凤皇于飞
双数	复数
双方	两边
反冲力	后坐力
反动	革命
反响	回响	回声	回音	应声
反哺之私	寸草春晖	春晖寸草
反复	重复
反客为主	反宾为主	太阿倒持	雀巢鸠占	喧宾夺主	鹊巢鸠占	鹊巢鸠居
反对	否决	住手	停止	制止	终了	终止	避免	阻当	阻挠	阻挡	阻梗	阻止	阻遏	幸免	抗御	提防	谨防	防备	防御	防止	防范	预防	严防
反常	变态	失常
反应	反映	反馈	回响反映
反悔	后悔	忏悔	悔怨	悔改	懊丧	懊悔	痛恨	厌恶	怅恨	憎恨	憎恶	仇恨	恼恨	愤怒	愤恨	怨恨
反感	恶感
反扑	反攻	扑打	扑挞	抨击	拷打	鞭挞	鞭笞	报复
反正	归正	横竖
反璞归真	洗净铅华
反老回童	回复青春	天保九如	长命百岁	长生不老	松乔之寿	长生久视
反诘	反问
反转展转	回转
反面	后头	后背	后面	背面	前面
反面教员	反面教材
反驳	回嘴	辩驳
发人深省	振聋发聩	发人深思	发人深醒	发蒙振聩	醍醐灌顶	震耳欲聋
发出	收回
发呆	发愣
发回	发还
发奋图强	自强不息	闻鸡起舞	鸡鸣而起
发妻	嫡妻
发急	焦急	着急
发愁	哀愁	忧愁	忧虑	忧闷	忧郁	担心	担忧	郁闷
发慌	发窘
发扬光大	踵事增华	阐扬光大
发抖	哆嗦	寒噤	寒战	惊怖	抖动	股栗	觳觫	颤动	颤抖	颤栗
发指眦裂	怒火中烧	怒火冲天	侧目而视	怒目而视	暴跳如雷	暴躁如雷	大发雷霆	忿然作色	怒气冲天	横眉立目	气急败坏	火冒三丈	勃然大怒	发上指冠	怒发冲冠	拊膺切齿	赐正	怒不可遏	怒形于色
发掘	开掘	挖掘
发源	发祥	来历	起源
发火点	起火点
发烧	发热
发狂	发疯
发短心长	老谋深算	心长发短	深谋远虑	老于世故	老奸巨猾	足智多谋	长虑后顾	长虑顾后
发端	发轫
发笑	失笑
发芽	抽芽	萌芽
发蒙	启蒙
发觉	察觉	觉察
发言	总论	泛论	畅谈	讲话	谈话
发话器	话筒
发财致富	恭喜发财	招财进宝
发迹	起家	起身
发酒疯	撒酒疯
发问	提问
取信	守信
取出	掏出
取利	图利	牟利
取得	失掉	得到	获得
取暖	取暖和
取水	吊水	打水	汲水
取而代之	拔帜易帜	拔赵帜立汉帜
取舍	弃取
受冤	含冤	抱冤	抱屈	负屈
受到	遭到
受命	奉命	衔命
受孕	妊娠	怀胎
受惊	吃惊
受惠	沾恩
受益匪浅	收获颇丰
受益无穷	获益良多
受贿	纳贿	行贿	贿赂
受阻	碰壁	碰钉子	碰鼻
受饿	挨饿
变名易姓	改名换姓
变成	酿成
变本加厉	无以复加	有加无己	肆无忌惮	登峰造极	至高无上	叹为观止
变质	蜕变
叙旧	话旧
叛逆	背叛	起义	作乱	倒戈	反叛	反水	变节	叛变	背离	哗变
口号	标语
口含天宪	口衔天宪
口实	话柄
口岸	港口
口干舌燥	口燥唇干	唇焦口燥	舌敝唇焦	费尽唇舌	唇焦舌敝	费尽口舌
口才	谈锋	辞令	辩才
口无遮拦	有天无日	有天没日
口是心非	心口不一	心谤腹非	两面三刀	佛口蛇心	笑里藏刀	表里不一	阳奉阴违	挂羊头，卖狗肉	炫玉贾石	言不由衷	口不应心
口血未干	言犹在耳	尸骨未寒	一唱三叹	余音绕梁	字正腔圆	绕梁三日	娓娓动听	念念不忘	记忆犹新
口角	是非	曲直短长
口试	笔试
口诛笔伐	笔伐口诛
口说无凭	空口无凭	无凭无据	空话无凭
口诵心惟	口诵心维
口齿伶俐	牙白口清
古井不波	老僧入定
古刹	庙宇
古玩	古董	骨董
古老	新颖	新鲜	时兴	迂腐	陈旧	陈腐
古诗	新诗
古貌古心	古道热肠
古道	旧道
古里古怪	阴阳怪气	怪声怪气
古雅	高古
另有	尚有
另楚寒巫	牛郎织女
另辟蹊径	独辟蹊径	标新立异	独树一帜	自出一家	自成一家	自我作古	与众不同	异乎寻常	领异标新
叨光	沾光
叨在知己	忝在爱末
叨教	请示	请问
叩谢	道谢	申谢	称谢	致谢	鸣谢
叩门	打门	拍门	扣门	敲门
只要	只需	只有	惟独
叫化	求乞
叫声	啼声
叫好	喝彩	喝采	欢呼
叫子	哨子
叫醒	唤醒
召集	招集	纠集	补救	调处	调集	集结
叮嘱	吩咐	嘱咐
可以	或许	能够
可口	适口
可否	是否	能否
可大可小	小大由之
可有可无	无关紧要	固执己见	无可无不可	不关紧要	无伤大雅	无关大局	无关宏旨	无足轻重
可望不可即	望尘莫及	瞠乎其后	难望项背
台甫	大名	奶名	小名
台端	大驾
叱呵	叱喝
叱骂	责骂	嗔怪	责怪	斥责	求全谴责	诘难	谴责	责备	责难	非难	驳诘	叱责	呵斥	呵责	呼叱	品评	批评	指摘	指斥	攻讦	评论	评述	指责	求全	诘问	诘责
史乘	史书	史册	史籍
号哭	号泣	哀号	悲啼	悲泣
司库	管库
司理	经理
叹伤	哀叹	悲叹
叹恨	怨嗟
叹息	叹气	感伤
叹惋	叹惜
吃一堑	长一智
吃力	费劲
吃力不讨好	费力不讨好
吃尽当光	罗掘俱穷
吃法	服法
吃穿用度	日常开销
吃素	茹素	食斋
吃苦	忍苦	俭朴
吃茶品茗	饮茶
吃醋	妒忌	嫉妒
吃里扒外	吃里爬外
吃饭	用饭
各为其主	邻女詈人	吠非其主	桀犬吠尧
各别	各异
各取所需	各得其所	得其所哉	求仁得仁
各就各位	各尽其责
各尽所能	各展其长
各式各样	林林总总
各持己见	常识	知识
各有千秋	各有所长	春兰秋菊	势均力敌	半斤八两	工力悉敌	平分秋色	旗鼓相当	不相上下	伯仲之间	棋逢对手	一丘之貉	患难之交	生死之交	金石之交	难兄难弟	全无分别	旗敌相当	难史难弟	一路货色	一鼻孔出气	泾渭不分	物以类聚
各种	各类	种种
吆喝	呼喊	召唤	号召	呼叫	呼唤	招呼	理睬
合乎	合适	适宜	相宜
合伙	合股	合资
合作无懈	紧密合作
合唱	合奏
独唱	独奏
合家欢乐	天伦之乐	和平共处	边尘不惊	含饴弄孙	和睦相处	抱子弄孙
合时	应时	当令	适时
合法	正当
合浦珠还	失而复得	合浦还珠	完璧归赵	物归原主
合理	平正	平允
合用	实用	无效	有效	有用	适用
合身	称身
吉人	吉士	良士
吉人天相	善者神佑	大吉大利	官运亨通	天道好还
吉兆	佳兆
天网恢恢	法网恢恢	恶有恶报
吉日良辰	黄道吉日	良辰美景	光风霁月	冰壶秋月	大好时光	花晨月夕	花朝月夕	花朝月夜	冰清玉洁	冰清玉润	不染纤尘	坐怀不乱	冰魂雪魄	吉日	谷旦
吉祥如意	万事大吉	万事亨通
吊丧	吊祭	吊问
吊挂	悬挂
吊销	拆除	撤消	撤除	裁撤	除去	除掉
同一	统一
同仇敌忾	敌忾同仇	同仇敌慨
同僚	同寅
同出一脉	同宗同气
同学	同砚	同窗
同工异曲	异曲同工	不约而同	不谋而合	异途同归	殊途同归	不期而同	不约而合	一致百虑	异口同声	不谋而同	不期而会	不期而遇	萍水相逢
同床共枕	长枕大衾	长枕大被
同床异梦	貌合心离	貌合神离	离心离德	钩心斗角	明争暗斗	鹿死谁手	龙争虎斗	明枪好躲，暗箭难防	明枪易躲，暗箭难防	明枪暗箭	明修栈道，暗渡陈仓	尔虞我诈	勾心斗角	尔诈我虞
同归殊途	殊途同归	必由之路	必经之路	方便之门	终南捷径	不二法门	举世无双	独一无二	盖世无敌
同心	齐心
同志	同道
同族	本家
同日而语	相提并论	等量齐观
同气连枝	手足同心
同盟	联盟
同等	一致	对等	平等	等同	划一	齐截	齐整
同等看待	比量齐观
同类呼朋	呼朋引类	相互勾结
同辈	平辈
名利双收	求名求利	功成名就	功成名遂	功德圆满	大功告成	旗开得胜	旗开马到	马到成功	克敌制胜	六出奇计	出奇制胜	出手得卢	直捣黄龙
名副其实	名实相副	名实相符	货真价实	名不虚传	名符其实	受之无愧	当之无愧
名垂青史	死得其所	永垂青史	流芳千古	流芳百世	永垂不朽
名堂	幻术	把戏	花招	花样	花腔	花色	诡计	魔术	狡计	计谋	阴谋	战略	策略	计策
名存实亡	有名无实	久假不归	兔丝燕麦	逾期不归	外强中干	徒有虚名	秀而不实	色厉内荏	虚有其表	外强内弱	外刚内柔	外方内圆
名师出高徒	强将手下无弱兵
名满天下	名高天下	天下闻名	如雷灌耳	如雷贯耳	闻名遐尔	举世闻名	驰名天下	驰名当世
名片	手刺
名胜	胜景
名落孙山	榜上无名
名贵	宝贵	珍贵	贵重	珍宝	至宝
名门	望族	王谢
名震一时	声誉鹊起	名噪一时	名闻遐迩	炙手可热	煊赫一时	敬而远之	昙花一现	望而生畏	烜赫一时	盛极一时
名高引谤	树大招风	众矢之的
后世	后嗣	后裔	昆裔	子息
后劲	潜力
后台	后援	后盾	布景	背景	配景	靠山
后妻	继室	继配
后悔无及	追悔不及	后悔莫及	悔之无及	追悔莫及	噬脐何及	噬脐莫及	懊悔无及
后手	回扣	夹帐	背工
后来	开初	新近	早先	起先	起初
后浪推前浪	长江后浪推前浪
后生可畏	少年事重	少年老成	大器晚成	弱不好弄	深思远虑	老成持重
后生小子	后生晚学
后记	跋文
后顾之忧	黄雀伺蝉	黄雀在后
吐哺捉发	吐哺握发	礼贤下士
吐逆	呕吐
向壁虚构	向壁虚造	乡壁虚造	凭空捏造	无中生有	凭空杜撰	闭门造车	小道消息	捕风捉影	海外奇谈	道听途说	齐东野语	望风捕影	深信不疑	疑神疑鬼	寻风捉影
向导	导游
向往	憧憬	神往	神驰
向荣	茂发
吓唬	恐吓
君子之交	君子之交淡如水	杵臼之交
吝啬	小器	鄙吝
吝啬鬼	守财奴
吞云吐雾	喷云吐雾	烟雾弥漫	波涛汹涌	烟波浩渺	白浪连天
吞刀刮肠	痛改前非	放下屠刀，立地成佛	改过自新	洗心涤虑	洗心革面	后悔莫及	悔过自新	悔过自责	改过迁善	改邪归正	迷途知返
吞吐其词	含混其词
吞吐其辞	吞吞吐吐	半吐半露	半吞半吐	含糊其词	闪烁其辞	结结巴巴
吟风弄月	咏日嘲月
吠影吠声	随声附和	拾人涕唾	拾人牙慧	鹦鹉学舌	一犬吠形，百犬吠声	与世俯仰	与世偃仰	人云亦云
否定	否认
含义	含意	寄义
含恨	怀怨	怀愁	抱恨	赍恨
含情脉脉	脉脉含情	暗送秋波	文质彬彬	温文尔雅	柔情脉脉	温情脉脉	温柔敦厚	彬彬有礼	以礼待人	礼贤下士	必恭必敬	毕恭毕敬	恭恭敬敬	肃然起敬	落落大方
含污纳垢	藏垢纳污	藏污纳垢
含混	含糊	暗昧	模糊	迷糊
含笑	浅笑	微笑
含笑九泉	含笑入地
含蓄	委婉	委宛	宛转	蕴藉	婉转	悠扬
启发	启示	启迪	开导
吴头楚尾	楚尾吴头
吴市之箫	吴市吹箫
吴牛喘月	喘月吴牛
吵嚷	喧嚷
吵杂	烦吵
吵架	打骂
吸取	吸收	排汇	汲取	罗致
吸烟	抽烟
吹吹打打	敲锣打鼓	锣鼓喧天	鼓乐齐鸣
吹嘘	吹捧	吹法螺	吹牛	揄扬
吹大法螺	吹牛皮
吹奏	演奏
吹打	奏乐	奏琴	弹琴	抚琴	操琴
吹毛求疵	求全责备	洗垢求瘢	洗垢索瘢	百般挑剔
吹气如兰	吹气胜兰
吹皱一池春水	管你何事
吹箫吴市	沿门托钵	沿门持钵	构词惑众	造谣生事	无中生有	无事生非
吻合	契合	相符	符合	切合
吼怒	咆哮	怒吼	狂嗥
呆笨	愚拙	迟笨	鲁钝	痴呆
呆若木鸡	泥塑木雕	天真烂漫	烂漫天真	天真无邪	活泼可爱	顺其自然	呆头呆脑	木鸡之呆	没头没脑	目瞪口呆
告急	垂危	弥留	求助	紧张	紧急	紧要	紧迫	乞助
告状	指控	起诉
告竣	杀青	达成
告老还乡	辞职归里	归去来兮	归心似箭	归心如箭
告退	辞职
告饶	求饶	讨饶
呐呐	期艾
呓语	梦话
呜咽	哽咽
周到	殷勤
周游	漫游	环游
周而复始	循环交替	循环往复	终而复始
周遭	方圆
呱呱坠地	呱呱堕地
味同嚼蜡	枯燥无味	索然无味	百读不厌	兴味索然	平淡无味	心灰意冷	兴致索然	垂头丧气	无精打采	没精打采	万念俱灰	灰心丧气	百无聊赖	精神萎顿	萎靡不振
味道	滋味
呵欠	欠伸
呻吟	嗟叹	太息	慨气
呼么喝六	呼卢喝雉	呼幺喝六	指手划脚	盛气凌人	指手画脚	比手划脚	挤眉弄眼	挤眉溜眼	眉来眼去
呼啸	喧哗	大声喧哗	大肆咆哮	吼叫	叫嚣	呼噪	哗闹	喧嚣	嘈吵喧斗	喧闹	热烈	繁华	闹热	鼓噪
呼天号地	呼天唤地	嚎天动地	嚎天喊地	擂天倒地
呼天抢地	怆地呼天	捶胸顿足	椎心泣血	痛心疾首	踣地呼天	嚎啕大哭	声泪俱下	痛不欲生	痛哭流涕	泪如泉涌	热泪盈眶	热泪纵横	老泪纵横	泪如雨下	潸然泪下
呼应	响应	相应	照应	照顾	赐顾帮衬
呼牛作马	呼牛呼马
命中	射中	掷中
命中注定	安之若命
命名	定名
命根子	命脉
命薄如花	红颜薄命	美人命薄
命蹇时乖	时运不济	命运多舛	流年不利	运交华盖
命运	运气	运限
命途多舛	生不逢辰	时乖命蹇	生不逢时
咀嚼	品味	品尝
咂嘴弄唇	咂嘴弄舌
和事老	鲁仲连
和婉	柔顺
和悦	安然平静	平和	平宁	平沽	贱卖
和煦	温煦	温暖	和暖	和气	和蔼	和顺	暖和	温和	温文	温柔	温顺	亲善	亲睦	友善	和善	和洽	和睦	慈爱	慈祥	敦睦	良善	辑睦	辑穆	驯良
和璧隋珠	奇珍异宝	昆山片玉
和缓	弛缓	懈弛	缓和
和蔼可掬	平心静气	心平气和	从容不迫	处之泰然	泰然自若	不慌不忙	视若等闲	安之若素	泰然处之	漠然置之	随遇而安	若无其事	镇定自如
和议	订定合同	协议同意
和颜悦色	平易近人	平易近民
咒骂	唾骂	詈骂	诅咒	谩骂	辱骂
咕咕唧唧	喁喁细语
咨询	征询
咱们	我们
咳声叹气	哀声叹气
咸宜	皆宜
哀兵必胜	师直为壮
哀告宾服	跪地求饶	哀告	求告
哀哀欲绝	悲不自胜	悲恸欲绝	悲痛欲绝	痛不欲生	欣喜若狂	哀天叫地	哀痛欲绝	心如刀割	心如刀绞	寻死觅活	死皮赖脸	肝肠寸断	痛澈心脾	万箭攒心	五内俱焚	死去活来	死而复活	起死回生	死而复生	华陀再世	药到病除	手到病除
哀怜	悯恻
哀思	哀痛	悲伤	悲哀	悲恸	悲戚	悲痛	沉痛	消极2	颓废	伤心	悲观2
哀恸顽艳	哀感顽艳	哀而不伤
哀毁瘠立	哀毁骨立	无肠可断
哀肠百转	愁肠寸断	忧心忡忡	悲天悯人	愁肠百结	心事重重	悲观厌世	愁肠九转	郁郁寡欢	人心惶惶	坐立不安	如坐针毡	心神不定	忐忑不安	忧心如焚	惶惶不安	提心吊胆	方寸已乱
哀鸿	流民	灾民
品德	道德	人品	人格
品种	种类
品级	等级	等第
品茗	喝茶
哂纳	笑纳
哄人	骗人
哄传	盛传
哄动	引动
哄堂大笑	捧腹大笑
哈腰	弯腰
响马	盗贼
哑忍	隐忍
哔叽	羽缎
哗笑	喧笑
哨兵	尖兵	斥候	标兵
哭笑不得	啼笑皆非	狼狈不堪	抱头鼠窜	捧头鼠窜	逃之夭夭	一败涂地	老鼠过街，人人喊打	落荒而逃
唆使	挑唆	挑拨	调拨
唇枪舌剑	针锋相对	舌剑唇枪	以眼还眼，以牙还牙	兵戎相见	水来土掩	短兵相接	不可开交
唇红齿白	朱唇皓齿	齿白唇红	明眸皓齿	眉清目秀
唠叨	絮聒
唯一	惟一	独一
唯唯诺诺	俯首听命	低眉折腰	俯首帖耳	唯唯否否	唯唯连声
唱本	曲稿
唱沙作米	唱筹量沙
唾弃	鄙弃	厌弃	嫌弃
商业	贸易
商号	店肆	店铺
商场	墟市	市集	阛阓
商定	约定
商店	商铺	市廛	市肆
商标	牌号
商量	磋商	切磋	协商	商讨	商议	商酌	探讨	磋议	筹商	筹议	索求	参议	商榷
啜泣	抽泣
啜菽饮水	饮水啜菽	饮水食菽
啮臂之交	死生之交	死生之契
喃喃自语	自言自语
善于	擅长	长于
善人	恶人
善价而沽	席珍待聘	待价而沽
善士	慈善家
善报	恶报
善策	良策
善自为谋	自作打算
善门难开	好人难做
喘息	喘气
喜信	喜讯
喜兆	好兆头	好运
喜剧	笑剧
喜好	快乐	爱好	乐趣	兴味	兴趣	喜欢	喜爱	意义	趣味	青眼	青睐	倾慕	爱慕	倾心	恋慕	羡慕	艳羡	醉心
喜报	捷报
喝酒	饮酒
喧扰	清净
喧闹	嘈杂	吵闹	喧华	嘈吵
喷射	放射
喷薄欲出	如日东升
喷饭	歕饭
喷香	喷鼻	喷鼻香	香气扑鼻
喽啰	走卒	走狗
嗜好	癖好
嗜酒如命	好酒贪杯
嗾使	教唆	调唆
嘁嘁喳喳	嘁嘁嚓嚓
嘉会	盛会
嘉勉	嘉奖	夸奖	夸赞	奖励	奖赏
嘉宾	贵客	贵宾	高朋
嘉言善行	嘉言懿行	瑰意琦行
嘲弄	揶揄
嘲谑	愚弄	戏弄	把玩	捉弄	玩弄	簸弄	辱弄与虎谋皮	海中捞月
嘲风咏月	嘲风弄月
嘴快	嘴紧
嘶哑	沙哑
嘹亮	洪亮	响亮	清脆
器具	用具
器宇不凡	气宇轩昂	龙行虎步	昂然不见	昂首望天	昂首天外	自视甚高	精神抖擞	英姿焕发	器宇轩昂	傲头傲脑	桀骜不驯	横冲直撞
器度	器量	度量	怀抱	襟怀	胸怀	襟怀胸襟
器重	珍视	重视	从新	正视	注重	从头	重新
噩梦	恶梦
囊中物	瓮中鳖
囊匣如洗	囊空如洗	不名一文	季子囊空	床头金尽	不值一钱	不直一钱	身无分文
囊括	席卷
囚徒	犯人	监犯	罪人	座上客	阶下囚
四不像	怪样子
四六文	骈体文
四周	周围
四壁萧条	室如悬磬	家徒壁立	一贫如洗	家徒四壁	不名一文	囊空如洗	床头金尽	两袖清风	廉洁奉公	阮囊羞涩	一寒如此	一无所有	洁身自好
四大皆空	心无杂念
四季	四序	四时
四海之内皆兄弟	四海皆兄弟
四肢举动	手脚
四面八方	天南海北	山南海北	五湖四海	八街九陌	六街三市	大街小巷	街头巷尾	三街六巷
回乡	回籍	旋里	还乡
回信	复书	复苏	昏倒	昏厥	昏迷	晕厥	答信	苏醒	覆信	清醒
回光反照	回光返照
回味无穷	耐人寻味	其味无穷	意味深长	情意深长	语重心长	语重情长	引人入胜	微言大义	言近旨远
回国	归国	返国
回复	回答	回覆	答复
回天乏术	无法复生
回心	转意
回心转意	心回意转
回忆	回想	回顾	回首	追念	回头	转头	返回
回报	待遇	报答	报酬	答谢	酬劳	酬报	酬谢	酬金	工资	工钱
回收	接纳	采取	采用	采纳	驳回
回来	回来离去	归来	返来	改行	转业
回禄	祝融
回绕	缭绕
回绝	拒绝	谢绝
回肠九转	回肠百转
回身	转身
回避	规避	躲避	逃避
回销	返梢
因为	由于
因势利导	趁风使舵	顺水推舟
因循	因袭	沿用	沿袭	相沿
因循自误	过后行兵
因敌为资	因敌取资
因果报应	种瓜得瓜，种豆得豆
因此	因而	是以
因祸得福	塞翁失马	因祸为福	亡戟得矛	佹得佹失	有得有失	北叟失马	否极泰来	失之东隅
因素	成分	要素	身分
团圆	团聚
团结	联合	联结	连合
团鱼	甲鱼
园丁	花匠
园地	场地
困心横虑	困心衡虑
困惑	嫌疑	怀疑	狐疑	猜忌	猜疑	疑心	思疑
困苦	干瘦	干瘪	憔悴	枯瘠
围巾	领巾
围绕	环抱	环绕	盘绕
固执	执拗	顽固	顽强
固然	虽然	当然
国事	国是
国交	邦交
国以粮为本	民以食为天
国土	国界	幅员	河山	版图	疆土	邦畿	领土
国学	国粹
国家	国度
国家荣誉	邦家之光
国富兵强	国富民强	民富国强
国本	国脉	邦本
国泰民安	太平盛世	海宴河澄	海晏河清	安居乐业	政修人和	政通人和	民安国泰	民安物阜	民康物阜	承平盛世	文治武功	经国济世	休养生息	养精蓄锐	安堵乐业	一张一弛	以逸待劳
国破家亡	山河破碎	丧家败国	败国丧家	剩水残山	残山剩水	半壁江山	荆棘铜驼	豆剖瓜分	半壁河山
国祚	国运	鼎祚
国蠹	民贼
国计民生	民生国计
国际	海外	国外	外洋
图书馆	藏书楼
图章	钤记
圈外人	第三者
圈套	陷阱	骗局
土产	本地货	特产
土人	土着土偶
土地	地皮	地盘
土壤	泥土
土头土脑	土气
土牛木马	土鸡瓦犬	石鼓沙田	土鸡瓦狗	陶鸡瓦犬	土龙刍狗
土生土长	根生土长
土阶茅屋	土阶茅茨
圣人	贤人
圣旨	诏书
在世	活着
在即	期近
在所无免	在所难免
在朝	执政
在行	熟手
圭臬	圭表标准	典型	典范	尺度	标准	楷模	榜样	模范	类型	范例	规范	圭臬标准	圭表
圮绝	屏绝
地主	田主
地利	天时
地动	地震
地动山摇	山摇地动	拔地摇山	山塌地崩	山崩地裂	山崩地陷	冰消瓦解	土崩瓦解	风声鹤唳	分崩离析	四分五裂	支离破碎	冰消冻释	冰解冻释	地崩山摧
地势	步地	阵势
地图	舆图
地址	地点	所在
地契	方单
地志	舆志
地方	处所
地方不宁	盗贼四起	萑苻不靖
地方官	父母官
地步	境地	境界	田地
地狱	天堂	天国
地理	地舆
地痞	泼皮	流氓	混混
场合	场所
场合排场	场面	局面	排场
均衡	平衡
坎坷	弯曲	曲折	盘曲	笔挺	笔直	蜿蜒	迂回	高低	妨害	挫折	波折	荆棘
坏人	坏蛋	大盗	奸人	恶徒	悍贼	暴徒	歹徒
坐以待旦	秉烛待旦
坐山观虎斗	坐观成败	作壁上观	坐视不救
坐拥书城	坐拥百城	大庭广众	稠人广坐	群贤毕集
坐筹帷幄	运筹帷幄	握筹布画	绸缪帷幄	置身事外	袖手旁观	见死不救	隔岸观火	事不关己	漠不关心	置之不理	置之脑后	不问不闻	不闻不问	置若罔闻	蔽明塞聪	蔽聪塞明
坑绷拐骗	坑蒙拐骗
坚决果断	毫不犹豫	当机立断	毅然决然	多谋善断	操刀必割	英明果断	应机立断	犹豫不决
坚固	巩固	稳固
坚壁清野	焦土政策	空室清野
坚持到底	贯彻始终	患难与共	相依为命	相须为命	同病相怜	同舟共济	吴越同舟	风雨同舟	守望相助	志同道合	意气相合	气味相合	气味相投	同心协力	和衷共济	一心一德	同心同德
坚甲利兵	强兵劲旅
坟场	墓地
坟墓	宅兆
坠溷飘茵	坠茵落溷	坠茵飘溷
坦克车	装甲车
坦率	坦白	率直	坦言
坦诚相待	赤心相待
垂垂	渐渐	冉冉	徐徐	缓缓
垂帘听政	牝鸡司晨	越俎代庖	包办代替
垂死	病笃
垂涎三尺	垂涎欲滴	馋涎欲滴
垂纶	垂钓	钓鱼
垂问咨询人	照拂
垦植	耕作	耕种	耕耘
垦荒	开荒	拓荒
埋天怨地	怨天尤人	怨天忧人	怨天怨地	不辞辛苦	任劳任怨	怨天恨地	自怨自艾	不敢告劳	任怨任劳	勤勤恳恳	吃苦耐劳
埋头	笃志
埋怨	抱怨	诉苦
埋葬	安葬	掩埋
城府深密	城府深阻	胸有城府
城开不夜	金吾不禁
城狐社鼠	狐假虎威	害群之马	残渣余孽	污泥浊水
城门失火，殃及池鱼	城门鱼殃
培修	维修
堆积	沉积	聚积
堆金积玉	金玉满堂
堕入	陷入
堕泪	流泪
堡垒	碉堡	营垒	阵营
堪舆术	青鸟术
塑像	泥像
塞翁失马，焉知非福	失之东隅，收之桑榆
墓木已拱	尸骨早寒
墓穴	泉台
墙头马上	花前月下	马上墙头	花天酒地	风前月下	风花雪月	柳影花阴	春花秋月	月下花前	竹马之交	竹马之友	青梅竹马	唇齿相依	耳鬓厮磨	辅车相依
增产节约	开源节流	强本节用
增加	增添	增进	增长	添加
增援	声援	支援
增补	弥补	补充	解救
墨守陈规	穷则思变	穷极思变
墨绿	茶青
壁立千仞	悬崖绝壁	悬崖峭壁	刀山火海	龙潭虎穴	刀山剑树	剑树刀山
壅闭	阻塞
士别三日，刮目相待	士别三日，刮目相看
壮举	豪举
壮心不已	老当益壮	宝刀未老	童颜鹤发	鹤发童颜	返老还童
壮志未酬	龟冷搘床	打道回府	班师回朝	荣归故里	衣绣昼行	衣锦昼行	衣锦荣归	衣锦还乡	还乡昼锦	锦衣行昼	得胜回朝	叶落归根
壮盛	鼎盛
声势赫赫	浩浩荡荡
声响	声音
声息	声气
声成金石	掷地有声	金声玉振
声气相投	声气相求	声气相通	意气相投	心心相印	心有灵犀一点通	心领神会	志同道合	情投意合	气味相投	莫逆之交	莫逆于心	同声相应	同气相求	声应气求	沆瀣一气	狼狈为奸	臭味相投	表里为奸
声色俱厉	正言厉色	正颜厉色	疾言厉色	不苟言笑	冷若冰霜	一本正经	道貌岸然
声色犬马	声色狗马	威信扫地	身败名裂
声调	腔调	调子	音调
处分	处罚	惩办	惩处	惩治	惩罚	责罚	贬抑	赏罚	抑低	奖惩
处堂燕雀	处堂燕鹊
处女	童贞
处死	正法
处理	处置	处置惩罚	措置
备尝艰苦	备尝辛苦
备案	存案	立案
复为故态	故态复作	故态复萌	故态复还	故伎重演	故技重演
复习	温习
复古	复旧	怀旧	念旧
复活	复生	新生	更生	重生
复电	来电
夏天	炎天
夏季	夏日
夏布	麻布
夏雨雨人	春风风人
夕阳	斜阳	落日
外助	外援
外号	绰号
外圆内方	外柔内刚	绵里藏针
外地	外埠
外型	造型
外套	外衣
外子	夫君	男子	良人	男子汉	须眉
外家	娘家
外形	形态	形状	情况	情形	情景	景象	景遇	状况	状态	环境	征象	现象
外患	外祸
外族	异族
外氏	舅家
外相	皮毛
外行	生手
外行人	门外汉
外表	外观	外面	皮相	表面	轮廓	外貌
夙儒	老儒
夙兴	夙起	早起
夙夜	旦夕	晨夕	朝夕	迟早
夙夜匪懈	日夜勉	夙夜匪解
多事之秋	艰屯之际
多事生非	好管闲事
多半	多数	大都
多多益善	贪多务得	贪得无厌	韩信将兵，多多益善	欲壑难填	清心寡欲	唯利是图	贪心不足	苟求不已	诛求无厌	得寸进尺	诛求无已
多愁善感	多愁多病	柔情似水
多次	屡次
多歧亡羊	泛而不专
多财善贾	多钱善贾	长袖善舞
夜不闭户	弊绝风清	道不拾遗	路不拾遗	不惊鸡犬	秋毫无犯	鸡犬不惊	耕市不惊
夜深人静	更阑人静
夜阑	更阑	深宵
夜雨对床	对床夜雨
够数	足数
夤缘	趋奉
大亨	富翁	财主
大众化	普通化
大众文学	民间文学
大体	大要	概况	概略	详情
大作	高文	鸿文
大公	至公
大军	雄师
大力成全	鼎力玉成
大功告成	如愿以偿	尽如人意
大动干戈	金戈铁马	雄姿英才
大北	大败
大半	泰半
大叫	大呼	大喊
大名鼎鼎	赫赫有名	举世闻名	名扬天下	名闻遐迩	如雷贯耳	扬名四海	遐迩闻名	闻名遐尔	驰名中外	鼎鼎大名	鼎鼎有名	举世瞩目	名震中外	引人注目	誉满天下
大哥	年老	年轻	年迈
大喜过望	如获至宝	喜出望外	哑然失笑	喜不自胜	忍俊不住	忍俊不禁	受宠若惊	被宠若惊
大地回春	春满人间	大地春回	春光明媚	春和景明	春暖花开	春暖花香	百花齐放	花红柳绿	燕语莺啼	燕语莺声	鸟语花香	柳绿桃红	桃红柳绿	莺啼燕语	柳绿花红	青山绿水
大声	高声
大处着眼	大处落墨	大处落笔
大奸	巨猾
大好人	好人
大好河山	锦绣河山	锦绣乾坤	锦绣山河	锦绣江山	山明水秀	旖旎风光	水木清华	湖山如画	风光绮丽	山清水秀	柳暗花明	湖光山色	美不胜收
大家风范	大将风度赤口白舌
大富	豪富
大富大贵	大红大紫
大小	巨细
大巷	大街
大师	巨匠	大家2
大年夜	除夜	年夜	年三十儿
大庭广众	稠人广众
大开眼界	大长见识
大德	盛德
大志	宏愿	弘愿	洪志	雄心
大快人心	拍手叫好	拍手称快	皆大欢喜	民怨沸腾	人心大快	普天同庆	喜不自禁	喜出望外	尽如人意	欢天喜地	欢欣鼓舞	欣喜若狂	喜从天降	大喜过望	如获至宝
大怒	盛怒	震怒
大恩大德	知遇之恩	知遇之感	雨露之恩
大惊小怪	失惊打怪	少见多怪	蜀犬吠日	见识浅短	旁敲侧击	藏头露尾	藏形匿影	转弯抹角	隐晦曲折	拐弯抹角	曲里拐弯	借题发挥	含血喷人	血口喷人	小题大作	指桑骂槐	指鸡骂狗
大意	粗心
大手大脚	大肆铺张	挥金如土	挥霍无度	铺张浪费	一掷千金	千金一掷	铺张扬厉	铺排张扬	坐吃山崩	坐吃山空	暴殄天物	穷奢极侈
大敌当前	生死存亡	生死攸关
大方	大雅	风雅
大族	富家	巨室
大星殒落	泰山其颓	泰山殒落
大显神通	大显身手	大展宏图	大展经纶	大有作为	大有可为	有所作为	庸庸碌碌	栗六庸才	前程似锦
大有人在	实繁有徒	实蕃有徒
大氅	斗篷
大水	急流	洪水	洪流	激流
大澈大悟	澈底觉悟
大相径庭	截然不同	迥然不同	天差地别	众寡不敌	众寡悬殊	大有径庭	寡不敌众	判若两人	判若鸿沟	天壤之别	大同小异	本同末异	求同存异	如出一辙	如同一口	判然不同	截然有异	一式一样	一模一样	神肖酷似
大礼服	燕尾服
大篆	籀文
大约	约莫	也许	可能	大抵	大概	大略	大致	或者	或许	梗概	粗略	约略	兴许
大纲	纲目	纲要	纲领
大腹便便	脑满肠肥	心宽体胖	满脑肥肠
大言	狂言
大败亏输	损兵折将	赔了夫人又折兵
大辂椎轮	开山鼻祖
大进	猛进
大逆不道	离经叛道	背信弃义	图为不轨	图谋不轨	犯上作乱	罪大恶极	罪孽深重	言而不信	食言而肥	自食其言	言而无信	言行不一	洪乔捎书	空头支票	见利忘义	见钱眼开	见钱眼红
大醇小疵	白壁微瑕	人无完人	金无足赤
大醉	烂醉	烂醉陶醉	酣醉
大量	大批	多量
大难	浩劫
大难临头	祸从天降	晴天霹雳	不祥之兆	凶多吉少	大祸临头	祸出不测	飞来横祸	危如累卵	累卵之危	摇摇欲倒	摇摇欲坠	风雨飘摇	一发千钧	不可思议	不堪设想	不绝如线	不绝如缕	危在旦夕	危若朝露	岌岌可危	燃眉之急
大雨如注	大雨滂沱
大题小作	小题大作	借题发挥	如临大敌	如临深渊	如履薄冰	胆战心惊	火中取栗	虎口夺食	虎口拔牙
大风大浪	狂风巨浪	惊涛骇浪
天下太平	相安无事	风平浪静	久安长治	长治久安	平安无事	水静无波	河清海晏	刀枪入库	国泰民安	天下大治	安家立业	歌舞升平	天下升平	偃武修文	卖剑买牛	夜不闭户	道不拾遗	马放南山	鸡犬不惊
天下归心	率土归心
天井	庭院
天佑	天助
天分	天禀	禀赋
天台	晒台	露台
天命	定命	定数
天堑	通途
天壤之别	天差地远	天悬地隔	天差地别	霄壤之别	霄壤之殊	天地之别	一龙一猪	天冠地屦	云泥之别	云龙井蛙	天渊之别
天子	皇帝
天孙	王孙
天年	天算
天怒人怨	怨声载道	怨天忧人	民怨沸腾
天性	本能	本性	特征	特性	个性	共性	本色	赋性	实质	特点	特质
天愁地惨	鬼哭神号	狼号鬼哭	鬼哭狼嚎	鬼哭神嚎
天才	蠢才
天才横溢	才气纵横
天摇地动	天旋地转	天崩地裂	排山倒海	移山倒海	揭地掀天	翻天覆地	排山压卵	搅海翻江	翻江倒海
天晴	晴和
天气	天色	气候	气象
天涯	天边	天际	海角
天涯海角	海角天涯	天各一方	日东月西	咫尺万里	咫尺千里	咫尺天涯	远在天边	天南地北	天南海北	山南海北
天灾人祸	飞灾横祸
天生	生成
天真	无邪
天真未凿	浑金璞玉	浑金白玉
天穹	苍穹
天立地之人	强中自有强中手	恶人更有恶人磨
天罗地网	网罗密布	天理昭昭	天网恢恢，疏而不漏	法网难逃
天翻地覆	翻天覆地	天崩地裂翻天覆地	天崩地坼	天崩地裂	震天动地	地动山摇	天塌地陷	天旋地转	头晕目眩	山崩地裂
天职	本分
天良	本心	本意	本旨	素心	良心
天资	资质
天造地设	神工鬼斧	鬼斧神工	巧夺天工
天高听下	天高听卑
天高气爽	秋高气爽	秋高气肃
太仓一粟	沧海微尘	九牛一毛	微不足道	沧海一粟	渺不足道	凤毛麟角	寥寥可数	寥寥无几	寥若晨星	屈指可数	九牛一毫	太仓稊米
太初	太始
太医	御医
太古	泰初	远古	邃古
太平	宁靖	承平
太平时世	清平世界
太甚	太过	过分	偏激	过度	过火
太监	宦官	寺人	阉人
夫唱妇随	鸾凤和鸣	举案齐眉	相敬如宾	心心相印	互敬互爱	如胶似漆	如鱼得水	相亲相爱	融为一体	难分难解	难解难分
夫子	役夫
夫役	挑夫	脚夫	苦力
夫荣妻贵	夫贵妻荣
夭折	短命	短寿	短折
央央大度	宽洪大度
央求	请求	恳求
失业	就业	待业	赋闲
失之交臂	当面错过	坐失良机	过后行兵	坐失机宜
失之毫厘，差之千里	失之毫厘，谬以千里
失仪	失礼
失信	失约	误期	负约
失势	得势
失去	落空
失宜	得宜
失实	属实
失宠	得宠
失容	失神	失色	忘形
失察	失策	失算	失计
失意	得志
失效	生效
失时	失机
失望	绝望	悲观1	气馁	泄气	灰心	消极1
失期	如约	履约	践约
失火	火灾	火警
失窃	失贼
失言	讲错
失路	迷途
失陷	沦陷	陷落
失魂落魄	梦想颠倒	梦魂颠倒	销魂夺魄	销魂荡魄	魂不守舍	魂飞天外	魄散九霄	丧魂失魄	六神无主	魂不附体	魂飞魄散	惊慌失措	手足无措	措手不及	无所措手	无所措手足	猝不及防	七手八脚	手忙脚乱	不迟不疾	丢魂失魄	从容不迫	快快当当	慌慌张张	慢条斯理	丧魂落魄
头子	头目
头痛医头，脚痛医脚	头痛灸头，脚痛灸脚
头童齿豁	蓬头历齿
头脑	思维	脑壳	脑袋
头面人物	首脑人物
头领	首级头目
夷易	平易
夷狄	蛮夷
夸大其词	言过其实	过甚其词	名过其实	过甚其实	过甚其辞	名不副实	徒有虚名	有名无实	溢美之言	广开言路	闭目塞听	哗众取宠	夸大其辞	夸夸其谈	虚有其表	表里不一	名不符实	悬羊头，卖狗肉	挂羊头卖狗肉
夸夸其谈	废话连篇	离题万里	空洞无物	空空如也
夸张	夸诞	朴实	浮夸	虚夸	憨厚	敦厚	敦朴	浑厚	浑朴	淳厚	淳朴	纯朴	老诚	质朴	俭朴	刚正	刚直	朴素	朴质	刚正不阿	坚毅刚烈	不吐不茹	公正不阿
夸耀	炫耀
夹击	夹攻
夹袋中人物	私人亲信
夺得冠军	独占鳌头
夺门而出	破门而出
奄奄一息	气息奄奄	苟延残喘	一丝两气	一息尚存	一线希望	一线生机	危在旦夕	岌岌可危	险象环生	摇摇欲坠	风雨飘摇	人命危浅
奇人	怪杰
奇光异彩	异彩纷呈
奇文瑰句	情文并茂	情景交融	斐然成章	触景生情	抚景伤情	见景生情	触物伤情	触景伤怀	触景伤情
奇文轶事	稗官小说	稗官野史
奇树异草	奇花异草	奇花异卉
奇策	空城计
奉养	赡养	伺候	侍奉	伺侯	侍侯	服侍	孝敬	孝顺	贡献	奉上	奉侍	奉献	赠给	赠送	进献	送上
奉行	履行	推行	推选	践诺
奉送	馈赠	馈送	馈遗
奋发向上	毁坏	破坏	破碎摧毁	粉碎	损坏	破损	割据	盘据	豆剖	决裂	分裂	割裂	幻灭	披垂	披散	破灭	破碎	破裂	碎裂
奋起	感奋	抖擞	振作	焕发
奋起直追	急起直追	迎头赶上
奏效	收效	见效
契合金兰	契若金兰
契约	左券
奔忙	奔波	奔走	驰驱	驱驰
奔放	豁达	豪宕	豪放	豪迈
奔流	奔腾	奔跑	奔驰	疾驰	飞奔	飞跃	飞驰
奔走钻营	挨风缉缝	捱风缉缝	见缝插针
奔轶绝尘	奔逸绝尘
奕棋	对奕
奚落	调停	调整	调解	排遣
奠基	奠定
奢华	豪华
奢求	苛求
奥秘	神秘	奇妙	奥妙	微妙	神奇	奇奥	巧妙	玄妙
女中丈夫	女中豪杰	巾帼英雄	巾帼须眉
女乐	歌女
女优	女伶
女侍	女婢
女儿态	脂粉气
女娲补天	炼石补天
女强人	铁娘子
奸佞	忠直
奸刁	奸狡	奸猾	沉醉	狡猾	陶醉	入神	沉浸	沉湎	沉溺	沉迷	着迷	陷溺
奸商	市侩
奸官污吏	贪官污吏	贪官蠹役	滥官污吏
奸徒	奸棍
奸淫	奸通	奸骗
奸笑	狞笑
奸细	特工	间谍
好久	很久	良久
好似	宛如彷佛	恰似
好友	密友	挚友	石友	老友
好受	难受
好处	益处	优点	利益	所长	甜头	长处
好大喜功	沽名钓誉	盗名窃誉	弄虚作假	欺世惑众	欺世盗名	盗名欺世	粉饰太平	阿世盗名	惑世盗名
好天	晴天
好奇	猎奇
好心	好意	善意
好本领	好身手
好梦	美梦
好梦难圆	好梦难成	一波三折	一波未平，一波又起	好事多磨	节外生枝	鲜花易谢
好汉	英雄	豪杰	铁汉
好生之德	慈悲心肠
好色之徒	酒色之徒	酒色财气
好行小惠	好行小慧
好逸恶劳	尸位素餐	无所事事	饱食终日	好吃懒做	游手好闲	不务正业	吊儿郎当	不堪造就	不宜深造	不成气候	不求上进	持禄	因陋就简	备位充数	滥竽充数	不劳而获	衣来伸手	饭来张口	上恬下嬉	文恬武嬉	坐享其成	坐收渔利	不义之财	不劳而食	坐地分赃	民脂民膏
如丧考妣	如失父母
如之奈何	如何是好
如坐云雾	如堕烟海	雾里看花	泾渭分明	若明若暗	一清二楚	旗帜鲜明	浊泾清渭	爱憎分明	黑白分明	若有若无	若隐若现	或隐或现	若存若亡
如坐春风	如沐春风	春风化雨	化雨春风
如夫人	小星	小老婆	细姨
如实	照实
如影随行	形影不离	形影相随	依依不舍	如影相随	如影随形	如胶似漆	寸步不离	影形不离	难舍难分	合两为一	合二为一	合而为一	水乳交融	胶漆相投	三位一体	亲密无间	如胶如漆	情投意合
如有	若有
如椽大笔	笔力扛鼎	笔大如椽
如芒刺背	如芒在背
如蚁附膻	如蝇逐臭	曲意逢迎	趋之如骛	趋之若骛	趋炎附势	趋之若鹜	趋附者众	串通一气	沆瀣一气	臭味相投
妄言	妄语
妆奁	嫁奁	嫁妆
妆扮	打扮	服装	梳妆	装扮
妇姑勃溪	妇姑勃谿
妊妇	孕妇
妍媸	美丑
妖冶	明媚
妖怪	魔鬼
妖装	浓妆	盛饰
妖言惑众	异端邪说	诡辞欺世	蜚短流长	闲言闲语	侜张为幻	蛊惑人心	含沙射影	含血喷人	血口喷人	造谣中伤	造谣惑众	造谣生事
妙不可言	妙趣横生	相映成趣	相映生辉
妙技	技术	技能	技艺	武艺
妙笔生花	神来之笔
妙算	神算
妙语横生	谈笑风生	神色自若	谈古说今	谈笑自若
妩媚	娇媚
始作俑者	罪魁祸首	元凶巨恶
姑且	权且
姑妄听之	姑妄言之	妄言妄听	随便说说
姑置勿论	存而不论	避而不谈	守口如瓶	退避三舍	避君三舍	心口如一	表里如一	表里相符	言而有信	言行一致	说一不二	心直口快	直肚直肠	缄舌闭口
姑苏	苏州
委决不下	难以决断
委婉曲折	指桑骂槐	皮里阳秋	打鸡骂狗	指山说磨	指黑道白	指鸡骂犬	一语双关	指鸡骂狗
委果	委的
姗姗来迟	捷足先登	捷足先得
姨妈	阿姨
姿势	姿态
威严	森严
威吓	恫吓
威德兼施	宽猛相济	恩威并用
威望	权势巨子	权威
威武	英武
威逼利诱	恩威并济	软硬兼施
威风凛凛	气势	八面威风	气势汹汹	其势汹汹	大摇大摆	咄咄逼人	劈头盖脸	狂风暴雨	盛气凌人	铺天盖地
娇小玲珑	小巧玲珑	玲珑剔透	短小精悍	伶牙俐齿	辩口利舌	辩口利辞	利齿能牙	聪明伶俐
娇皮嫩肉	细皮嫩肉
娇羞答答	羞人答答
娘舅	母舅	舅父	舅舅
娟秀	清秀	秀气
娱乐	文娱
娴熟	精通
娴静	文静	娴雅	闲雅
娶妻	授室
娶妾	纳宠
婚丧喜事	红白喜事
婢作夫人	婢学夫人
媒婆	牙婆
媚惑	狐媚
媾和	宣战	议和	讲和
嫁狗逐狗	嫁狗随狗	嫁鸡逐鸡
嫁祸	移祸
嫁鸡随鸡	彩凤随鸦
嫌贫爱富	欺贫爱富	爱富嫌贫
嫡亲	至亲	近亲
嫡派	嫡系
嫩芽	新苗
嬉戏	游玩	玩耍
孀妇	寡妇	未亡人	孀居	寡居
子弹	枪弹
子虚	虚伪	虚假
子音	辅音
孔方兄	阿堵物	钱	金钱
孔殷	殷切	迫切
字斟句酌	寻枝摘叶	寻章摘句	寻行数墨
字谜	灯谜
字迹	笔迹
存亡	生死	死活
存亡未卜	生死未卜
存亡绝续	存亡继绝	存亡续绝
存候	存问	致意	请安
存心	居心	成心	故意	有心	有意
存放	寄存	寄放
存款	贷款
存身	藏身安身
孝子慈孙	孝子贤孙	孝子顺孙
季世	末世
季候	季节	时令	气节
季子	幼子
孤介	孤僻
孤儿寡妇	孤儿寡母
孤拐脸	孤拐面
孤掌难鸣	孤立无援	独木难支	孤军作战	孤家寡人	难鸣孤掌	匹马单枪	单人独马	单刀赴会	一手一脚	一手一足	单枪匹马	匹夫之勇	智勇双全	有勇无谋	血气之勇	大智大勇	孤军深入
孤本	秘本
孤芳自赏	洁身自好	肥遁鸣高	自命不凡	自命清高	顾影自怜	才高气傲	目无余子	目空一世	目若无人	自高自大	好为人师	妄自尊大	师心自用	不可一世	唯我独尊	夜郎自大	惟我独尊	目空一切	骄傲自满	傍若无人	旁若无人	目中无人	咄咄逼人	大摇大摆	大模大样	盛气凌人
孤负	辜负
孤雁失群	虎落平川	虎落平阳	蛟龙失水
学习	深造	进修
学富五车	着作等身	腹载五车	经纶之才	饱学之士	才高八斗	满腹文章	满腹经纶	才当曹斗	立地书橱	八斗之才	博学多才	博览群书	文江学海	学识渊博	精神满腹	读书破万卷
学无止境	学海无涯	知也无涯	不到乌江不尽头	不到黄河心不死	矢志不移	地久天长	永无止境	海枯石烂	海誓山盟	矢志不渝	愚公移山	排山倒海	移山倒海	精卫填海	翻江倒海	鲲鹏图南
学校	黉舍
学识	学问
学费	膏火
孱弱	羸弱
孺子	童子
孺慕	渴念
宁为玉碎，不为瓦全	宁当玉碎	宁死不屈	坚贞不屈	威武不屈	坚毅不拔	坚刚不屈	坚定不移	坚强不屈	坚贞不渝	坚韧不拔	始终如一
宁神	安心	定心	放心	释怀
宁缺毋滥	宁遗勿滥
宅券	房契
宅忧	居丧	居忧
宇量	气量
守候	期待	等候	等待
守兵	戍卒
守分	守拙
守志	守节	持志
守正不回	守正不挠	守正不阿	正直无私	刚正不阿	坚强不屈	光明正大	光明磊落	心口不一	胸无城府	胸无宿物	襟怀坦白	明人不做暗事	正大光明	浩然之气
守法	遵法
守身如玉	洁身自爱	守身若玉	洁身自好	出污泥而不染	出淤泥而不染	泥而不滓	涅而不缁
安不忘危	居安思危	常备不懈	提高警惕	防患未然	临阵磨枪	临渴掘井	临阵磨刀	措手不及	严阵以待	壁垒森严	厉兵秣马	枕戈待旦	盛食厉兵	不舍昼夜	俾昼作夜	夜以继日	坐以待旦	朝干夕惕
安乐	安泰	愉逸
安于现状	不思进取	不求进取	安于一隅	安故重迁
安产	顺产
安内攘外	抽薪止沸	釜底抽薪
安堵如故	相安无事	息事宁人	兴妖作怪	兴风作浪	引风吹火	推波助澜	泼油救火	火上加油	火上浇油	呼风唤雨	好肉剜疮	惹是生非	无事生非	如虎添翼	精益求精	锦上添花	煽风点火
安家立业	安家落户	安营扎寨	落地生根	安营下寨	步步为营	了身达命	安身立命	安居乐业	家成业就	成家立业	安生乐业	安生服业	安土重迁	恋恋不舍
安富尊荣	荣华富贵
安富恤穷	安富恤贫	治国安民	治国安邦
安常处顺	安常履顺	安时处顺
安息	安眠	休息	休憩	安歇	憩息	歇息	苏息
安慰	慰藉	刺激	劝慰	安抚	宽慰	抚慰	劝解
安枕而卧	高枕无忧	无忧无虑
安步当车	缓步徐行
安然无事	安然无恙	平安无事	安然如故	一路平安	一路福星	一路顺风	安如泰山	福星高照	十拿九稳	安如磐石	垂手可得	易如反掌	轻而易举
安知	怎知
安老怀少	敬老爱幼	敬老慈幼
安营	扎营
安贫乐道	安贫守道
安身之地	安身之处
安邦定国	安邦治国	济国安邦
完全	绝对	全盘	完好	无缺	通盘	齐全	齐备
完善	完满	完美	美满
完场	拆档
完好无损	完整无缺	金瓯无缺
完婚	结婚
完工	落成
完整	残破	残缺	完备	统统
完稿	脱稿
完美无缺	白璧无瑕	十全十美	天衣无缝	浑然一体	止于至善	至善至美	尽善尽美	尽如人意	称心如意
宏伟	雄伟	高大	高峻
宏图	雄图
宏大	弘大
宏观	微观
宏论	弘论
宗子	长子
官僚	权要
官厅	官署
官司	讼事
官场	宦海	政界	脱节
官逼民反	揭竿而起	逼上梁山	铤而走险	挺而走险	无可奈何	迫不得已	逼不得已
定义	界说
定亲	订亲	订婚	文定
定价	订价
定例	定规
定则	定章
定期	按期	活期
定见	意见
定都	建都
宝塔	浮图	浮屠
宝山空回	空入宝山回
宝物	宝贝	法宝	瑰宝
宝穴	铜山
宝马香车	香车宝马
实习	练习	训练
实力	气力
实施	实行	实验	施行
实词	虚词
实话	真话	瞎话
实话实说	打开天窗说亮话	无可讳言	直言相告
实质	本质	素质	素养
宠任	宠信
宠儿	骄子
宠姬	爱妾
宠爱	溺爱	痛爱	钟爱	宠嬖
宠辱祸福	生杀与夺
审定	核定
审察	打量	端详	端相
审慎	谨慎
审核	查核	稽核	考核
审问	过堂	鞫讯	审判	审讯	鞠问
客死他乡	客死异乡
客籍	寄籍
宣布	揭晓	揭橥
宣扬	鼓吹	公布	发布	发表	颁发	颁布	声张	宣传	宣布	张扬	鼓动	广告
宰衡	辅弼	首相
害人不浅	贻害不浅
害病	得病	患病	扶病	抱病	染病	生病	罹病
害羞	忸怩	腼腆	含羞	害臊	怕羞
宴安鸠毒	晏安鸠毒	燕安鸠毒
宴客	请客	宴请	招待	款待
家世	门第
家乡	家园	田园	老家
家乡父老	江东父老
家传	祖传
家养	野生
家反宅乱	家翻宅乱
家境	家景	家道
家声	门风
家庭祸变	萧墙之祸
家贫壁立	环堵萧然
家长	怙恃	父母
容光焕发	生龙活虎	精神抖擞	精神焕发	满面红光	方兴未艾	朝气蓬勃	欣欣向荣	生气勃勃	方兴未已	方滋未艾	如日中天	旭日东升	蒸蒸日上	蓬勃发展	万紫千红	姹紫嫣红	百花争艳	百花齐放	春意盎然	春色满园	云兴霞蔚	云蒸霞蔚	五彩缤纷	五色缤纷	五颜六色	花团锦簇
容头过身	得过且过
容貌	边幅	样子	模样	容颜	相貌	外表
宽免	宽贷豁免	豁免
宽大	广大	恢弘	泛博	辽阔
宽大为怀	宽宏大量	恢宏大度	网开一面	网开三面	豁达大度	廓达大度	气度恢宏	捐弃前嫌
宽广	宽敞豁达	广漠	广阔
宽恕	饶恕
宽泛	广泛	普及	普遍	遍及	遍布
宽衣大带	褒衣博带
宽限	改期	缓期	脱期
宾客盈门	高官厚禄	胜友如云	风云际会	高朋满座	宾朋盈门	宾朋迎门	宾客如云
宿债	旧债
宿将	老将
宿帐	旧帐
宿疾	沉痾	重病
宿病	旧病
寂寥	寥寂
寂然	肃然	颓然
寄宿	投止
寄意	寓意
寄身	托身
寄迹	托足
寅吃卯粮	等米下锅	入不敷出	寅支卯粮	绰绰有余	捉襟见肘	恢恢有余	绰有余裕	绰绰有裕
密密麻麻	稀稀拉拉	密密层层	鳞次栉比	人山人海	水泄不通	熙熙攘攘	风雨不透	挨山塞海	三三两两	摩肩接踵
密意	深情	蜜意
密码	暗码
富可敌国	金玉满堂
富商	巨贾	殷商
富国安民	富国强兵	富国强民
富强	强盛	壮大	弱小	强大
寒冬	穷冬	隆冬
寒冬腊月	残冬腊月
寒家	敝宅
寒带	热带
寒暄	应酬	酬酢	应付	搪塞	敷衍	关于	凑合	唐塞	塞责	对于	对付	马虎	拼凑	拼集
寒流	暖流
寒耕暑耘	寒耕热耘
寒舍	舍下	舍间
寒门饮恨	牛衣对泣
寓居	居住
寓所	居所
寝衣	睡衣
寝食不安	食不甘味	食不下咽	心神不宁	心神不定	七上八下	忐忑不安	忐忑不定	不可终日
察访	查访
寸	微暇
寸丝不挂	袒裼裸裎	赤身露体	一丝不挂	赤身裸体
寸心	寸衷
寸晷	寸阴
寸步不让	毫不让步	寸土不让	寸土必争
寸步难移	无法动弹
寸积铢累	积少成多	聚沙成塔	集腋成裘	千里之行，始于足下	日积月累	积水成渊	积铢累寸	积土成山	铢积寸累
对准	瞄准
对弈	棋战
对待	看待
对手	敌手
对换	对调
对消	抵消
对牛弹琴	对牛鼓簧	白费口舌
对联	春联
对证	对质
寺库	当铺
寻找	寻觅	探求	根究
寻求	谋求	追求	钻营
寻衅	挑战	挑衅	搬弄
导引	扶引
导火线	引火线
导致	招致
寿比南山	海屋添筹	海屋筹添	延年益寿	美意延年	中途夭折	祛病延年	万寿无疆	长命百岁	长生不老	青春永驻
封妻荫子	拔宅上升	拔宅飞升
射手	弓手
将取姑与	将欲取之，必先与之	欲取姑与
将就	迁就
将心比心	设身处地	身临其境	推己及人	能近取譬	以己度人	以升量石	以小人之心，度君子之腹	审时度势	揆情度理	以意逆志	度德量力	量力而行	揆理度情	揣时度力	详情度理	看菜吃饭	称体载衣	量体裁衣	实事求是	精打细算	量入为出	量入为用	量入制出
将来	未来
将遇良才	棋逢敌手	将遇良材	棋逢对手	众寡不敌	众寡悬殊	寡不敌众	敌众我寡
尊严	庄严	肃静
尊姓	贵姓
尊姓台甫	尊姓大名
尊崇	尊敬	尊重	崇拜
尊师重道	程门立雪	尊师重教
尊府	府上	贵寓
尊老爱幼	扶老携幼	敬老尊贤
尊贵	崇高	高尚	高贵
小丑跳梁	幺么小丑	跳梁小丑
小人得志	瓦釜雷鸣
小儿百姓	赤子
小商小贩	小本经营	本小利微
小坐	略坐
小姐	蜜斯
小巧	玲珑
小引	短序
小往大来	阴消阳长
小房	斗室
小扣	轻敲
小童	幼童
小肚鸡肠	鸡肠狗肚	睚眦小忿	睚眦必报	鼠肚鸡肠
小节	末节
小试锋芒	牛刀小试
小路	巷子
小雨	细雨
少小	年少	幼年
少少	极少
少憩	暂休
少用	常用	罕用	以偏概全	管见所及	一概而论	混为一谈	一知半解	只知其一，不知其二	囫囵吞枣	浮光掠影
尔后	此后	然后	而后
尖嘴猴腮	长颈鸟喙
尖嘴薄舌	尖酸刻薄	繁言吝啬	冷酷无情	刻薄寡思	口轻舌薄
尘事	尘务
尘土	尘埃	灰尘
尝尝	试试
尝试	测验考试
就地	当场
就教	求教	讨教	请教
就汤下面	趁机行事
尸体	尸身	尸首	遗体
尸居余气	老朽无能	日薄崦嵫	日薄西山	气息奄奄	人命危浅	命在旦夕	奄奄一息	岌岌可危	弥留之际	日暮途穷	日落西山
尸祝代庖	越权代理
尸解	登仙
尸谏	死谏
尸骨	尸骸	骸骨
尸骨未寒	骨肉未寒
尺寸之功	微薄之劳
尺布斗粟	尺缕斗粟
尺幅千里	掌上河山	尺寸千里
尺有所短	尺有所短，寸有所长	尺短寸长
尽力	致力	起劲
尽头	止境
尽忠	效忠
尽职	渎职	溺职	失职
尾月	腊月	十二月
局内人	此中人
局限	限制	限定	限度
层台累榭	层楼累榭
层次	条理
居不重席	居不重茵
居功自傲	居功自恃	恃功矜能
居心叵测	心术不正	心术不端	卑鄙手段	鬼蜮伎俩	心怀鬼胎	腹有鳞甲	阴谋诡计	佛口蛇心	刀头之蜜	包藏祸心	口蜜腹剑	甜言蜜语
居无定所	飘泊无定	飘萍断梗	飘蓬断梗
居高临下	高屋建瓴	高高在上
屈指可数	微乎其微	聊胜于无	一丝一毫	一星半点	一草一木	一针一线	寥若晨星	不足挂齿	微不足道	小小不言	不足齿数	不在话下	不屑一顾	不言而喻	不言而谕	无庸赘述	显而易见
屈辱	辱没
屈驾	枉驾
屋子	房子
屏声敛息	屏气慑息	屏气敛息
屏蔽	屏障	樊篱
展开	睁开
展望	揣度	揣摩	揣摸	猜度	猜测	瞻望	预测	琢磨	揣测	臆测	判别	判断	忖度	忖测	推断	推测	测度	猜想	推想	料到
展现	展示	揭示	显现	闪现	体现	出现	呈现	显示	显露	浮现	表现
展览场	陈列所
屠戮	戕害	杀害	杀戮	殛毙
屠烧	焚杀
屠狗之辈	市井之徒	市井小人
屡教不改	累教不改
履险如夷	履险若夷
山人	蓬户士	蓬菖人	隐士
山公	猴子
山君	老虎
山妻	山荆	拙荆
山寨	盗窟
山岳	山峰
山川	山水
山林隐士	野鹤闲云
山河	江山
山洞	岩穴
山清水秀	绿水青山
山穷水尽	穷途末路	走投无路	日暮途穷	万劫不复	内外交困	内忧外患	断港绝潢	走头无路	朝不保夕	朝不虑夕	朝不虑昔	朝不谋夕	危在旦夕	岌岌可危	朝不及夕	弹尽粮绝	穷途末日	危如朝露	厝火积薪	大厦将倾	大厦将颠	盲人瞎马	九鼎一丝	千钧一发	濒临绝境
山长地远	山高水长
山门	庙门
山雨欲来风满楼	黑云压城城欲摧
屹然	耸然
屹立	挺立	直立	矗立	竖立	耸峙	耸立
岁入	岁收
岁尾	岁终	年底	年末
岁数	年数	年齿	春秋
岁暮	年尾	年终
岁月	年代	年光	年华	年成	年景	年月	年青	年光光阴	韶华
岁月峥嵘	峥嵘岁月
岁比不登	比岁不登	比年不登
岁首	年关	年初	年头
岂非	莫非	难道
岑岭	巅峰	极峰	顶峰	颠峰	高峰	山顶
岔路	岔路支路	支路	歧路
岗亭	岗位
岿然不动	稳如泰山	纹丝不动	傲然屹立	坚如磐石	安如泰山	巍然屹立	安如磐石	文风不动	巍然不动	一了百了	依然如故	荡然无存	一如既往	一成不变	依然故我	原封不动
崇敬	恭敬	恭顺	敬服	敬重	爱崇
崩溃	溃散	溃逃	解体	瓦解
崭新	极新	簇新	据有
崭露头角	脱颖而出	锋芒毕露	崭露锋芒	显露头角	怀才不遇	骥伏盐车	材大难用	大材小用	悔读南华	黄钟毁弃
巍峨	横亘	绵亘	魁岸
川流不息	接二连三	接踵而至	联翩而至	络绎不绝	继续不停	人头攒动	人山人海	源源不断	纷至沓来	绵延不断	连续不断	连绵不断	车水马龙	骆驿不绝
巡回剧团	旅行剧团
巡察	梭巡
巡查	巡逻	放哨
巢倾卵破	巢倾卵覆	巢毁卵破	鸡飞蛋打	水净鹅飞	水尽鹅飞	唇亡齿寒	唇齿相依	息息相关	辅车相依	不解之缘	互为表里	共为唇齿	藕断丝连	难解难分	休戚相关	十指连心	同舟共济	精诚团结	精诚所至	风雨同舟	齐心协力	互相关注	痛痒相关	不破不立	与民同乐	与民更始
巢木居野	穴居野处
工厂	工场
工头	领班
工巧	工细
工整	工致
左券在握	瓮中捉鳖	胜券在握
左右	摆布
左右夹攻	并行不悖	钳形进攻	并肩前进	并驾齐驱	齐头并进	平起平坐	等量齐观	不相上下	八两半斤	平分秋色
左右开弓	左宜右宜	左宜右有	双管齐下
左近	相近	邻近	附近
左邻右舍	街坊邻里
左顾右盼	瞻前顾后	探头探脑	三心二意
巧不可阶	巧妙绝伦
巧妇难为无米之炊	无米难为炊
巧舌	巧言	巧语
巧言邪说	析辩诡词	析辩诡辞
巨制鸿篇	鸿篇巨制	鸿篇巨着
差之毫厘，失之千里	差以毫厘，失之千里
差之毫厘，谬以千里	差以毫厘，谬以千里	毫厘千里
己饥己溺	爱人如己
已往	过去	曩昔	过来	以前	畴昔
已经	曾经
巴不得	恨不得
市价	时价	时值
市情	市道	市道市情	市面
布匹	布疋
布帛菽粟	柴米油盐	衣食住行
布掸子	拂尘	接风
布衣	平民
布衣之交	微时之交
布衣交	贫贱交
布衣粝食	布衣蔬食	布被瓦器	粗茶淡饭	朝齑暮盐	清汤寡水	粗衣恶食	粗衣淡饭	粗衣粝食
布裙荆钗	荆钗布裙	粗衣布服	钗荆裙布
布防	设防
布阵	排阵
布鼓雷门	班门弄斧	故作姿态	自以为是	自作聪明	自行其是	高自标树	高自标置	高自标誉
帆柱	帆樯	帆竿	桅竿
帆海	航海
帆船	风帆
师傅	徒弟	门徒
师法	效法
帖伏	驯伏
帖服	服帖
带同	携同
带月披星	戴月披星	披星带月	披霜冒露
带路	领路
带领	率领
帮凶	鹰犬	爪牙	虎伥
帮助	资助	赞助	副手	匡助	协助	帮忙	帮手	扶助	扶直	接济	搀扶帮助	辅佐	辅助	帮衬
帮狗吃食	帮虎吃食
帮闲钻懒	耍乖弄巧
常常	经常
常年	终年	长年
常见	稀有	罕有	罕见	无数	有数
常规	惯例	老例	通例
干与	过问
干休	收手	罢手	歇手
干冷	湿热
干净	洁净	清洁
干扰	急躁	搅扰	暴躁	浮躁	滋扰	烦扰	烦躁	焦躁	脾气火暴	躁急
干柴烈火	烈火干柴
干涉	干预
干练	精壮	精干	精悍
干证	旁证
平地	高山
平地一声雷	飞必冲天	石破天惊
平坦	平展	平整
平局	平手
平年	闰年
平心定气	平心易气	态度冷静
平心而谈	持平立论
平昔	平素	素常
平淡无奇	淡而无味	平铺直叙	七颠八倒	乱七八糟	反反复复	杂乱无章	胡说八道	语无伦次	语言无味	颠三倒四	颠来倒去	千头万绪	杂七杂八	杯盘狼藉	横七竖八
平稳	颠簸	晃动	晃悠	晃荡	闲逛	动摇	挥动	摆荡	摇动	波动	挥舞	不乱	不变	稳定
平缓	陡峭	峻峭	悬崖	陡崖	绝壁
平话	评话	说书
年事	年岁	年纪	年龄
年华虚度	虚度光阴	虚度年华
年深日久	年湮代远	多历年所	日久天长	日久年深	日积月累	天长地久	成年累月	长年累月	天长日久	常年累月	海誓山盟	山高水长	海枯石烂	矢志不移
年深月久	积年累月	积岁累月	长年累月	天长日久	地久天长	天长地久	旷日持久	长此以往	海枯石烂
年轻力壮	手轻脚健	年富力强	年迈力衰	春秋鼎盛	矫若惊龙	身强力壮	力壮身强	年轻气盛	血气方刚
年轻貌美	绮年玉貌
并且	而且
并日而食	草衣木食	食不果腹	大肠告小肠	饥肠辘辘	饥不择食
并肩而立	比肩而立
并蒂芙蓉	芙蓉并蒂
幻境	幻景	幻梦
幽丽	幽美
幽暗	昏暗	晦暗	阴晦	阴暗	阴沉	惨淡	惨然	暗淡	暗澹	黯淡	灰暗	阴森
幽灵	鬼魂
幽禁	软禁
幽谷	深谷
幽静山谷	曲径通幽
幽香	暗香	清香
广开才路	招贤纳士	求贤如渴	求贤若渴	爱才如命	爱才若渴	爱才若命
广播	播送
广阔天地	无边无际	海阔天空	一望无际	一马平川	漫无边际	不着边际1	应有尽有	恩重如山	无穷无尽	昊天罔极	茫茫无际
庄重	正经	矜重	端庄	肃静	严肃
庇荫	荫庇
床上安床	迭床架屋	叠床架屋	头上安头	屋上架屋	多此一举	明知故问	把饭叫饥	画蛇添足	弄巧成拙	画龙点睛	冠上加冠
床笫	枕席
序文	序言
庐山真面	庐山真面目	庐山面目	真相大白	内情毕露	水落石出	原形毕露	图穷匕见	拨云见日	暴露无遗	真相毕露	穷形尽相	本来面目
应命	报命
应对	应答
应当	理当	该当
应时而生	应运而生
应许	批准	承诺	理睬	答允	答应	答理	许诺	允许	同意	核准	许可	赞成	允诺	许愿	准许	容许	应允	应承
底本	蓝本
店保	铺保
庞眉皓发	白发苍颜	白发银须	皓首苍颜	庞眉皓首
废弛	败坏	松弛	松懈
废料	废物
度日	过活
度过	渡过
座无虚席	济济一堂	宾朋满座	高朋满座
庶务	杂务	琐务	碎务
庸人自扰	杞人忧天	替古人担忧
廉正宽厚	廉而不刿
廓清	澄清
延伸	延误	延长	耽搁	耽误	延宕	延迟	担搁	拖延	耽延	迟延	迟误	稽延	迁延
延接	款接
延揽兜揽	抖揽
延聘	礼聘	约请	聘请	邀请
延颈举踵	延颈企踵
开云见天	开云见日	重睹天日	重见光明	重见天日
开会	散会
开口见心	开口见胆
开基创业	开基立业
开怀	畅意	舒怀
开疆拓土	开疆辟土
开禁	弛禁
开花	着花
开花结实	开花结果	春华秋实
开锣喝道	开锣鸣道
开门揖盗	引狼入室
开麦拉	摄影机
弁冕	礼帽
弁急	遑急	刻不容缓	如饥似渴	急切	急迫	火急	迫切	急不可待	迫不及待	间不容缓	千钧一发	火烧眉毛	燃眉之急	眉睫之内	迫在眉睫	心如火焚	心急如焚	心急火燎	急如星火	急不可耐	搓手顿足
弁言	引言	小序
异议	贰言
异邦	番邦
弃之可惜	弃之可惜，食之无味
弃捐	弃置
弃文就武	弃文竞武	投笔从戎
弃明投暗	明珠投暗	明珠暗投
弃暗投明	背暗投明	改过自新	清夜扪心	闭门思过	改恶从善	改过迁善	改邪归正	放下屠刀	痛改前非	改头换面	洗面革心	推陈出新	改弦更张	洗心革面	焕然一新	面目一新	新陈代谢	回天之力	旋转乾坤	改天换地	旋干转坤
弃瑕取用	弃瑕录用
弄堂	胡衕
弄月	赏月
弄法	玩法
弄狗相咬	挑拨是非	拨嘴撩牙	搬口弄舌	搬弄是非	无事生非	见风是雨	遇事生端	遇事生风	寻事生非	惹是生非	无理取闹	无风起浪	无中生有	为非作歹	惹事生非
弄鬼掉猴	调皮捣蛋
弊端	弱点	毛病	漏洞	瑕玷	破绽	缝隙	缺点	缺陷	裂缝	马脚	坏处	妨碍	害处	弊病	故障	流弊	流毒	短处	系统故障
式微	衰落
式样	模样形状	状貌	神志	神态
弓套	弓鞬
弓影浮杯	杯弓蛇影	草木皆兵	风声鹤唳	壁间蛇影	疑神疑鬼
弓足	金莲
引人注目	有目共睹	招摇过市	白日衣绣	彰明较着	明白昭彰	昭然若揭	显而易见
引以为戒	殷鉴不远	前车之鉴	覆车之鉴	前车可鉴	前人失脚，后人把滑
引发	激发	激起
引商刻羽	引商角羽
引导	指导
引港	领港
引用	援用
引经据典	旁征博引
引绳批根	引绳排根
引而不发	枕戈待旦	枕戈以待	枕戈坐甲	枕戈寝甲	披坚执锐	持枪实弹	荷枪实弹
引起	惹起	引人	惹人
引车卖浆	贩夫走卒	平民百姓	贩夫皂隶	匹夫匹妇	布衣黔首
引颈受戮	束手待毙	小手小脚	束手就擒	计无所出	小家子气	一筹莫展	悲观失望	无能为力	束手无策	楚囚对泣	半筹不纳	半筹莫展
引颈就戮	束身待罪
弘远	远大
弟妇	弟媳
弟子	门生
张三李四	张王赵李
张公吃酒李公醉	李代桃僵	移花接木	偷梁换柱	移天换日	移宫换羽	掩人耳目	掩耳盗铃	自欺欺人	遮人耳目	偷天换日	欲盖弥彰	瞒上欺下	批红判白	以假乱真	弄虚作假
张望	观望
张牙舞爪	耀武扬威	凶相毕露	呲牙咧嘴	青面獠牙	横行霸道	霸道横行	作威作福	飞扬跋扈	盛气凌人	金刚怒目
张皇	慌乱	慌张
张罗	筹措
弥天大慌	欺人之谈	迷人眼目	弥天大谎	迷天大谎	漫天大谎	瞒天大谎
弥天大祸	灭顶之灾
弥天大罪	滔天罪行	滔天之罪
弥漫	洋溢
弦外有音	话里有话	一语双关	话中有话	意在言外	书不宣意	言不尽意	意味深长	拐弯抹角	词不尽意	词不达意	音在言外	字里行间	弦外之音	言外之意	大有文章
弯弯曲曲	曲曲折折
弹压	镇压
强人	强者	能人
强制	强迫	强逼	逼迫	羞耻	耻辱	侮辱	凌辱	欺侮	欺凌	欺压	欺负	羞辱	陵暴	陵虐
强横	蛮横	霸道	健壮	刁悍	强暴	茁壮	强悍
强烈热闹	热烈
强词夺理	满嘴胡缠	蛮不讲理	蛮横无理
归入	纳入
归咎	归罪
归真反朴	归真反璞	返朴归真
归程	归途
归纳	概括	综合
归纳	归结	演绎
当众出丑	当场出丑	当场出彩
当作	看成
当先	领先
当初	现在	今朝	如今	目前
当务之急	燃眉之急	事不宜迟	迫在眉睫	兵临城下	十万火急	急如星火	迫不及待	寒不择衣	慌不择路	狼吞虎咽	饥不择食	哑口无言	张口结舌	急不择言	瞠目结舌
当地	本地	内地	内陆	腹地	要地
当头一棒	当头棒喝
当家作主	当家做主
当局	政府
当年	昔时
当心	把稳	留心	留意	留神	注意
录音	灌音
形只影单	鸾只凤单	鸾孤凤只	势单力薄	门单户薄	单丝不成线	形单影只	身单力薄	鸾孤凤寡	孑然一身	孓然一身	形影相吊	伶仃孤苦	孤苦伶仃	举目无亲	无依无靠	孤芳自赏	茕茕孑立	顾影自怜	鳏寡孤独
形容	形貌	描写	描摹	描述
形态万千	形态各异
形态体式	格式方式
形而上学	玄学
形迹	踪迹
彤云	浓云
彤霞	红霞
彩笔生花	梦笔生花
彪形大汉	赳赳武夫
彪炳	特出
彪炳千古	彪炳日月	万古流芳	万古留芳	名垂万古	名垂千古	名垂后世	名垂青史	重于泰山	不可磨灭	垂范百世	永垂不朽	流芳百世	永不磨灭
彰善瘅恶	惩恶扬善	激浊扬清	隐恶扬善	遏恶扬善
影射	暗射	隐射
影象	记忆
彷徨	徘徊	徜徉	盘桓	倘佯
彷徨歧途	徘徊歧路
彼一时，此一时	此一时，彼一时
彼众我寡	敌众我寡
彼倡此和	彼唱此和	此唱彼和	前呼后应	夫唱妇随	首尾相应
彼岸	此岸
彼此一样	彼此彼此
彼竭我盈	敌疲我扰
往事	旧事
往复	来去
往日	旧日	昔日
征伐	挞伐
征引	援引
征求	搜聚	收罗	采集
征税	纳税
征聘	征请
征采	搜刮	搜寻	搜索
待时而举	待时而动	相机而行
徇私枉法	营私作弊	营私舞弊	贪赃枉法	贪赃舞弊	徇私舞弊	欺公罔法	徇情枉法	营私舞弊	巧取豪夺	暴取豪夺	敲诈勒索	上下其手	以权谋私	贪赃枉法
很多	良多	许多
很是	极其	极度	极端
律师	状师
徐行	缓步
徒劳无功	炊沙作饭	炊砂作饭	磨砖作镜	磨砖成镜
徒然	枉然
得不偿失	明珠弹雀	随珠弹雀	大材小用	牛鼎烹鸡	大器小用
得失成败	成败利钝	成败得失
得悉	得知	获悉
得意	满意	称心	自得	自满	傲慢	自豪	骄傲	高傲
得意门生	高足弟子
得救	获救	解围
循循善诱	耳提面命	谆谆告诫	谆谆教导	诲人不倦
循环	轮回
微小	细小	藐小
微波粼粼	微波荡漾
微风	轻风
微风小雨	斜风细雨
微风细雨	雨丝风片
德律风	电话
德性	德行	品格	品行	品质	操行	质量	风致
德才兼备	才高行厚	才高行洁	品学兼优	全知全能	多才多艺	文武全能	文武双全	才疏志大	才疏意广	才高意广	又红又专	德高望重	才德兼备
心中无数	胸中无数
心中有数	成竹在胸	胸有定见	匠意于心	胸中有数	胸有成竹
心事	苦衷
心伤	心酸	心疼	疼爱	心痛	肉痛
心余力绌	汲深绠短
心向往之	心弛神往	心驰神往	梦寐以求	求之不得	馨香祷祝	望眼将穿	望穿秋水	令人神往	望眼欲穿	力所不及	无可奈何	无能为力	望洋兴叹	力不胜任	力不能支	力不从心	心有余而力不足	爱莫之助	爱莫能助	鞭长莫及
心地	心肠
心如古井	心如止水
心思	心理	生理
心意	情义	情意	情谊
心慈手软	心狠手辣	心慈面软	利欲熏心	自私	自私自利	东食西宿	为富不仁	唯利是图	见利忘义	贪得无厌
心慌意乱	方寸已乱	心乱如麻	心烦意乱	坐立不安	担惊受怕	胆战心惊	心如乱麻	心神不安	心神不定	忐忑不安	惴惴不安	惶恐不安	如坐针毡	芒刺在背	举止失措	局促不安	手足无措
心慕手追	心慕笔追
心折	心服
心旷神怡	赏心悦目	悠然自得	怡然自得	逍遥自在	逍遥自得
心明眼亮	眼明手快	耳聪目明
心曲	襟曲
心有余悸	谈虎色变	闻风丧胆	惊弓之鸟	草木惊心	伤弓之鸟	漏网之鱼	心惊肉跳	肉跳心惊	动魄惊心	惊心动魄	惊魂动魄	提心吊胆	胆战心惊	心胆俱裂	惊恐万状	神不守舍	魂飞魄散
心有余而力不足	爱莫能助	鞭不及腹	鞭长不及	鞭长莫及	力不从心	鞭长不及马腹
心机	心计心情	神思
心浮气躁	粗心大意	粗心浮气	粗枝大叶	毛手毛脚	马马虎虎	心粗气浮	随随便便	大而化之	偷工减料	敷衍了事	得过且过	敷衍塞责	苟且偷生	草草了事	做一天和尚撞一天钟
心灰意冷	意气消沉	哀莫大于心死	心灰意懒	暮气沉沉	没精打彩	灰心丧气	心如死灰	萎靡不振	筋疲力尽	精疲力尽	精疲力竭	人困马乏	风尘仆仆	没精打采
心灵手巧	手脚灵便	精明强干	精明干练	游刃有余	熟能生巧	不费吹灰之力	举手之劳	举手投足	举重若轻	发蒙振落	易如反掌	轻而易举	手挥目送	目送手挥	如臂使指	左右逢源	庖丁解牛	得心应手	心手相应	称心如意	随心所欲	驾轻就熟	唾手可得	轻车熟路	迎刃冰解	迎刃而解
心病	芥蒂
心病还须心药医	解铃系铃	解铃还需系铃人
心直口快	快人快语	快嘴快舌	冲口而出	口快心直	脱口而出	口直心快	单刀直入	开门见山	直截了当	直抒己见	直言不讳	开宗明义	无庸讳言	八字打开	指名道姓	毫不隐讳	直呼其名
心算	默算
心胆俱寒	胆破心惊
心腹之患	肘腋之患	腹心之疾	心腹大患	变生肘腋	祸生肘腋
心血来潮	灵机一动	随机应变	便宜从事	便宜施行	便宜行事	见机行事	看景生情	看风使舵	看风使船	看风驶船	因风吹火	顺水推舟	见风使舵	见风转舵	随风转舵
心裁	机杼
心醉情移	色授魂与	神魂颠倒	精神恍惚	日思夜梦	魂牵梦萦	颠三倒四	神思恍惚
心高气傲	骄气十足	好高骛远	心浮气盛	不自量力	志大才疏	眉高眼低	眼高手低	一无所能	一无可取	一无所好	一无所长	一无是处	一团漆黑	暗无天日	百无一是
必不挠北	稳操胜券	万无一失	十拿九稳	可操左券	决胜千里	安若泰山	满有把握	不差毫厘	不差毫发	不差累黍	丝毫不差	准确无误	毫厘不差	不失分毫	毫发不爽	百无一失
必定	必然	肯定	一定
必操胜券	稳操左券	稳操胜算
必然王国	自由王国
必要	需要	需求
必里迟离	重阳佳节
必需	必须
忆苦思甜	温故知新
忌惮	顾忌	顾虑
忌日	忌辰
忌讳	禁忌	隐讳
忍辱负重	降志辱身	委曲求全	将心相随	忍气吞声	降心相从	饮泣吞声	相忍为国	忍无可忍	低声下气	逆来顺受	唾面自干	含垢纳污	含垢藏疾	含垢忍辱	忍受	忍尤含诟	忍耐	忍辱含垢	三从四德	三纲五常	清规戒律	百依百顺	礼义廉耻
忍饥挨饿	挨冻受饿	挨饿受冻
忐忑不安	惘然若失	若有所失	茫然若失	坐立不安	踧踖不安	坐卧不安	心旌摇摇	心潮起伏	坐卧不宁	诚惶诚恐	惶恐不安	神思恍惚	若有所思
忖量	思念	吊唁	哀悼	怀念	悲悼	留念	眷念	纪念	追悼
志同道合	惺惺惜惺惺	惺惺相惜	情投意合
志向	抱负	理想	幻想	梦想	空想
忘却	淡忘	忘怀
忘性	记性
忙碌	繁忙
忤逆	违逆
忧色	怒色
快刀斩乱麻	快刀断乱麻	一刀两断	薪尽火灭	难解难分	壮士断腕	壮士解腕	当机立断	不相上下	势均力敌	棋逢对手	相持不下	地丑德齐	不分伯仲	不差上下	并驾齐驱	分庭抗礼	半斤八两	平分秋色	平起平坐	旗鼓相当
快慰	欣慰	欣喜
快速	疾速
念书	读书
念佛	念经
忸捏	惭愧	羞愧
忻忭	欢忻
忽然	溘然	突然	遽然	俄然	倏忽	骤然
忽略	疏忽
怀孕	有身
怀恨	挟恨
怀璧其罪	象齿焚身	怀璧之罪
态度	立场
态度严肃	正襟危坐	不苟言笑	老成持重	一本正经	装腔作势	道貌岸然	正颜厉色
怅惋	怅惜
怅惘	迷惘	怅然	欣然	可惜	怜惜	惋惜	痛惜	大骂	痛骂
怆然泪下	怆然涕下
怏怏不乐	怏怏不悦
怒冲冲	气冲冲	气呼呼	气汹汹	气鼓鼓
怒放	盛开
怒斥	申斥	痛斥	训斥
怒气	怒火	肝火	喜气
怒潮	怒火万丈	愤恚	愤愤不平	愤慨	斗气	气忿	气愤	狂潮	怒气满腹	怒火中烧	嬉笑	恼怒	愤怒	(脾气)爆发	发作	发火	生气	怄气	怒气冲冲	怒气冲发	火冒三丈	生气希望
怒目	横眉	瞋目	横目
怜贫恤老	怜贫惜老	惜老怜贫
怜香惜玉	惜玉怜香	惜香怜玉	招蜂引蝶	沾花惹草	山盟海誓	海约山盟	海誓山盟	男欢女爱	不干不净	偷鸡摸狗	小偷小摸	惹草拈花	惹草沾花	拔葵啖枣
思不出位	老实本分
思如涌泉	文思敏捷
思惟	思想	脑子	脑筋
思索	思考	思量	考虑
思绪	思路
思绪万千	浮想联翩
思虑	担忧
怠倦	疲乏	倦怠	困乏	困倦	委靡	委顿	疲倦	疲劳	疲困	疲惫	疲钝	疲顿
急不择言	急不择路	急不暇泽	慌不择路	饥不择食	望门投止	病急乱投医
急中生智	情急智生	情急生智	人急智生	人急计生	计上心来	计上心头
急乎乎	急巴巴	急忙忙
急于星火	急如星火	火烧眉毛	迫在眉睫
急人之困	急人之急	急人之难
急变	遽变
急救	抢救
急脉缓受	急脉缓灸
急转直下	渐入佳境	相持不下	大势所趋	弃邪从正	弃邪归正	改弦易辙	改弦更张	改邪归正	改变方式	除旧更新	革故鼎新	一反其道	一反常态	一反既往	一改故辙	回心转意	弃旧图新	洗心革面
性命交关	性命关天
性情	性格	脾性	脾气	性子	性质
怨言	牢骚
怪罪	见怪	见责
怪诞不经	荒谬绝伦	荒诞不经	荒诞无稽	诞妄不经	大谬不然	荒谬不经
怫郁	愤懑	愤激	怨愤
怯夫	懦夫	胆小鬼
总共	统共
总揽	统辖
总是	老是
恋爱	爱情
恍如隔世	隔世之感
恍然大悟	茅塞顿开	醍醐灌顶	名顿开	豁然开朗	大彻大悟	豁然贯通	顿开茅塞	如梦初醒	开雾睹天	憬然有悟	大梦初醒
恒河沙数	数以万计	满坑满谷	千千万万	论千论万
恩义	恩德	恩惠	恩惠膏泽	蓬勃
恩仇	恩怨
恩典	恩情	恩泽	膏泽
恩赐	赏赐	犒赏
恬不为怪	恬不知怪
恬淡	恬澹	淡泊	澹泊
恬淡无为	清静无为	清净无为
恬逸	恬静	惬意	温馨	舒畅	舒适
恭喜	祝贺	庆祝	庆贺	道贺
恭行天罚	替天行道	龚行天罚
息款	息钱
恰到好处	恰如其分	适可而止	毫发不爽	下不为例	不为已甚
恰是	正是
恳求	申请	请求	乞求	哀求	请援	乞援	讨援	讨救
恶人得势	歹徒横行
恶劣	顽劣
恶妻	泼妇	悍妇
恶意	歹意
恶棍	无赖
恶浊	肮脏	龌龊
恶疾	顽疾
恶行	罪行	罪恶	罪状	罪过	邪恶	险峻	险恶	险要
恶衣恶食	粗衣劣食
恶马恶人骑	相生相克
恻隐之心	同病相怜	惺惺相惜	悲天悯人	怜悯	恻隐
恼	末路
恼羞成怒	暴跳如雷	气喘吁吁	气喘如牛	气急败坏	老羞变怒	老羞成怒
悄悄	轻轻	静静	平静	清静	寂静	幽静	微微	悄然	暗暗	沉寂	默默	幽深	清幽	安宁	安定	安谧	安逸	安闲	安靖	安静	平和	平定	恬静	清闲	舒适	闲适
悔悟	悔过	改悔
悖逆	逆悖
悠久	悠长
悠闲	清闲	空隙	落拓	逍遥
悬崖勒马	迷而知返	迷途知反	迷途知返	弃恶从善	浪子回头	迷而知反	误入歧途	歧路亡羊	回头是岸
悬念	悬疑
悬想	揣想
悬赏	赏格
悱恻缠绵	缠绵凄怆	缠绵悱恻
悲喜交集	感慨万端	百感交集	悲喜交至	惊喜交集	惊喜欲狂	惊喜若狂	可歌可泣
悲天悯人	与人为善	大发慈悲	大慈大悲	宽大为怀
悲欢离合	离合悲欢	酸甜苦辣	人之常情	人情世故	喜怒哀乐
悲歌慷慨	慷慨悲歌
情不自禁	油然而生	自然而然	不由自主	身不由己	不能自制	不能自已	城下之盟	鬼使神差
情之所锺	情有独锺
情味	情趣
情态	神情	神气
情愿	甘心	甘愿	愿意	志愿	意愿	自愿	乐意
情报	谍报
情随事迁	水涨船高
惆怅	难过	可贵	难得	为难	尴尬	忧伤	痛苦	舒服	难受	难堪	难熬
惊世震俗	惊世骇俗
惊叹	齰舌
惊天动地	触动	震动	震天动地	震惊	震荡	震天骇地
惊心吊胆	惊心悼胆静谧	从容	冷静	岑寂	沉着	自在	自由
惊惶	错愕
惊惶失措	惊恐万状	惶惶不可终日	闻风丧胆
惊讶	惊诧	愕然	诧异
惜墨如金	精益求精	一字不苟	句斟字酌
惟利是图	爱财如命	爱钱如命	锱铢必较	人为财死	贪夫徇财	一毛不拔	斤斤计较	讨价还价	寸量铢称	患得患失	自私自利	琐屑较量	不拔一毛	分斤拨两	分斤掰两	分金掰两
惟妙惟肖	有血有肉	栩栩如生	维妙维肖
惟恐	生怕
惠然之顾	惠然肯来
惦念	惦记	想念	缅怀	驰念
惧罪	畏罪
惨淡经营	苦心经营	苦心造诣	苦心孤诣	费尽心机	机关用尽	机关算尽
惨白	红润	苍白
惨绿少年	翩翩公子
惨绿愁红	愁红怨绿	愁红惨绿	残花败叶
惨重	极重繁重	沉重	深重	繁重
惩前毖后	杀一儆百	杀鸡儆猴	杀鸡吓猴	杀鸡骇猴	歼一警百	小惩大诫	小惩大戒	惩一儆百	严惩不贷	以儆效尤	绳之以法
惩恶劝善	隐恶扬善	人弃我取	陈善闭邪	不念旧恶	以德报德	以德报怨	以直报怨	以礼相待	豁达大度	礼尚往来	宰相肚里好撑船	宽宏大度	宽宏大量	豁略大度	不存芥蒂	休休有容
惭凫企鹤	自惭形秽	自感汗颜	自愧不如	自愧弗如	妄自菲薄	自轻自贱
想望丰采	想望风采
想法	设法	主意	意见	建议	观点	主见	看法	意识	认识
惶惑	惶惶	惶遽
惹事	惹祸	生事	肇事	闯事	闯祸	闹事
惹恼	触怒
愁容	笑容	笑脸	笑貌	笑颜
愁眉苦眼	愁眉锁眼	愁云满面	愁眉不展	愁眉苦脸	颦眉促额	愁眉泪眼	闷闷不乐	忧心如焚	忧心忡忡	郁郁寡欢	内心不安	忧心如捣	小弁：我心忧伤，惄焉如捣	愁肠百结
愁肠百结	满腹忧愁
愈甚	更甚
意会	领悟
意味	象征
意图	用意
意在沛公醉翁之意不在酒	项庄舞剑	项庄舞剑，意在沛公
意在笔先	意在笔前
意在言外	意在言表	溢于言表	言外之音
意外之灾	飞来横祸
愚者千虑，必有一得	智者千虑，必有一失
感人至深	激动人心	震撼人心
感叹	感喟	感到	感受	感召	感导	感应	感想	感慨	感染	劝化	慨叹	陶染	熏染	传染	作用	感动	感化	浸染	冲动	打动	激动
感德	感念	感怀	感恩	感愧交集	感激	感激涕零	感谢	戴德
感恩图报	结草衔环	感恩戴德	感激涕零	忘恩负义	背恩弃义	背恩忘义	辜恩负义	不知恩义	见利忘义	过河抽板	过河拆桥	利令智昏
感谢	谢谢
愤世嫉俗	愤时嫉俗	避世绝俗	避世离俗
愿望	欲望
慈善	慈悲
慌脚鸡	毛姜
慎重	稳重
慑伏	震怖
慢待	轻慢	骄易
慢慢	逐步	逐渐
慢条斯理	漫条斯理	老牛破车	蜗行牛步
慧业才人	慧业文人
慰劳	慰问
慷慨捐生	慷慨赴义	殒身不恤
慷慨淋漓	慷慨陈词
慷慨激昂	激昂慷慨	志在四方	雄心壮志	雄心勃勃	青云之志	鸿鹄之志	豪情壮志	豪言壮语	狼子野心	野心勃勃	胸怀大志	仁义道德	豺狼成性	丧尽天良	惨无人道	豺狐之心	丧心病狂	伤天害理	灭绝人性	穷凶极恶
懂礼节	礼貌
懊恼	烦恼
懵懂	糊涂
懵懂一时	糊涂一时	聪明一世	聪明一世，懵懂一时	聪明一世，糊涂一时
戈壁	沙漠	荒漠	疏弃	荒原	荒废	荒野
戍守	防卫	防守
戏剧演员	梨园子弟
戏班	梨园
成一家言	自成一家	独树一帜	别开生面	别树一帜	异军突起	另起炉灶	重整旗鼓	重新努力别辟门户	别具一格	匠心独运	标新立异	别树一旗	独具匠心	独辟蹊径	标新领异	别出心裁	标新创异	自出机杼	不落俗套	不落窠臼	别具匠心	别出机杼	另具匠心	步人后尘	独出机杼	追随骥尾
成事不足，坏事有余	成事不足，败事有余
成仇	构怨
成仙	羽化
成全	玉成
成则为王，败则为寇	成则为王，败则为贼	成王败寇
成功	胜利
成千盈百	成百上千
成双作对	成双成对	无独有偶	骈四俪六
成名术	登龙术
成天	整天	终日
成年累月	积日累久
成日成夜	整日整夜	日日夜夜
成本	本钱	资本	资源
成衣	裁缝
成规	陈规	陋习
成语	针言
我见犹怜	楚楚可怜	小鸟依人	妩媚动人
戒勉	饬厉
戒备森严	森严壁垒	重门击柝	无懈可击2	滴水不漏1	盛水不漏	纤介不遗	纤悉无遗	无隙可乘
或人	某人
或曰	或谓
戗风	逆风	顺风
战争	战役	战斗
战云浓密	鼙鼓雷鸣
战场	沙场	疆场
战火纷飞	炮火连天	烽烟遍地
战线	阵线
战胜	得胜	获胜	告捷
战败	打败	失利	败北
戛玉敲金	戛玉锵金
截长补短	移多补少	取长补短	裁长补短	裒多增寡	裒多益寡	从善如流	从善若流	从谏如流	择善而从	见贤思齐
截鹤续凫	断鹤续凫
戳穿	揭穿	拆穿	掩饰	梳妆化妆	润饰藻饰	点缀	粉饰	装点	掩蔽	掩藏	讳饰	遮掩	遮盖	遮蔽	隐瞒
戴头识脸	有头有脸
戴笠乘车	贫贱之交
户枢不朽	户枢不蠹	流水不腐
房东	房主
房屋	衡宇	屋宇
房钱	租金
所嫁非人	遇人不淑
手到回春	着手成春
手印	指模
手无寸铁	赤手空拳	手无寸刃
手本	抄本
手杖	拐杖
手简	手翰
手艺	才具	才力	才华	才干	才智	才气	才略	才能	才调	技巧	本事	本领	材干	能力	身手
手表	腕表
手足昆季	昆仲	昆玉
手足胼胝	手足重茧
才人	秀士
才华出众	才华盖世	八斗之才	才华横溢	才识过人	才高八斗	才气无双	才气过人
才思	才情
才望兼隆	才望高雅
才疏学浅	赐墙及肩	才薄智浅	吴下阿蒙	德薄能鲜	略识之无	孤陋寡闻	学浅才疏	浅尝辄止	浅见寡识	寡闻少见	蠡测管窥	蠡酌管窥	殚见洽闻	目光如豆	不识一丁	不识之无	不学无术	目不识丁	胸无点墨
才貌出众	才貌双全	才貌超群
扎实	结壮	踏实	壮实	结实
扑朔迷离	虚无缥缈	迷离恍惚	迷离扑朔
扒手	窃匪	窃贼
打倒	打垮
打劫	掠夺
打听	探询探望
打坏	打碎
打定主意	拿定主意
打家劫舍	放辟邪侈	无所顾忌	杀人越货	毫不在乎	肆无忌惮	趁火打劫	明火执杖
打手势	打手式
打扮服装	装束
打扰	打搅
打救	搭救	陷害	拯救	挽救	援救	谗谄
打斗	打架	斗殴
打死老虎	打落水狗
打狗不看主人面	罔顾情面
打猎	狩猎	佃猎
打盹	瞌睡
打眼号	递眼色
打破沙锅璺到底	打破沙锅问到底
打秋风	抽丰
打草惊蛇	风吹草动
打蛇打七寸	擒贼先擒王
打赌	赌博	赌钱
打趣	玩笑
打针	注射
打顺风旗	打顺风锣
打饥荒	闹饥荒
打马虎眼	阳奉阴违	马上房子	两面三刀	反复无常	朝三暮四	翻云覆雨	翻手为云，覆手为雨	覆雨翻云	三头两面
打鱼	捕鱼	网鱼
扔掷	投掷	抛掷
托病	称疾
托言	饰辞
扣头	折扣
扣盘扪烛	扣盘扪龠
扣问	讯问	询问
执法如山	言出法随	令行禁止	秉公执法	刚正不阿	铁面无私	法不阿贵	法网无情	大公无私	明镜高悬
执绋	送丧	送葬
扩充	裁减	减少	淘汰	镌汰
扪心	抚心	抚摩	抚摸
扪心自问	抚躬自问	内视反听	反躬自省	反躬自问	澈夜扪心	闭门思过	闭阁思过
扫兴	没趣	败兴
扫地以尽	扫地出门	一扫而光	一扫而空	一网打尽	斩草除根	全军覆没	片甲不回	片甲不留	全军尽没	无一生还	不留余地	剗草除根
扫墓	省墓
扫尾	收尾
扫荡	涤荡
扬名	立名
扬善斥恶	扬清激浊
扬声恶骂	破口大骂	口出不逊	含血喷人	咕哝不已	喋不休	大吹牛皮	大张其词	大言不惭	出言不逊	大吹大擂	自卖自夸	自吹自擂	自我吹嘘
扬汤止沸	负薪救火	救火投薪	以汤止沸	以火救火	事与愿违	适得其反
扭捏	摇摆	摇晃	摇曳	摇荡
扯开	撕开
扯破	撕裂
扯谈	胡诌
扯谎	撒谎	说谎
扳缠不清	牵丝扳藤	纠缠不清	牵扯不清	藕断丝连	难舍难分	依依不舍	依依惜别	恋恋不舍	留连不舍
扳话	攀话	交谈	攀谈
扶危济困	济弱扶倾
扶持	搀扶
扶携提拔	提携
批亢捣虚	批吭捣虚	捣虚批吭
批示	指挥	指示
批驳	驳倒	驳斥	批判	褒贬
扼守	把守	拒守	据守	看守
扼杀	抹杀
扼要	简明	简要
找事	谋事
承上启下	继古开今	继往开来	承先启后	承前启后
承情	领情
技击	武术
抄写	誊写	书写	晋升	誊录	抄录	缮写	钞写	钞缮
抄掠	搜劫
抉剔	挑剔
把持	操作	操纵
把持不住	把持不定
把握	掌握	操作	驾御	驾驭	把持
把柄	痛处
把玩无厌	百玩不厌
把素持斋	持斋把素
把薪助火	抱薪救火	火上浇油	饮鸩止渴	撮盐入火	救焚投薪	救焚益薪
抑制	按捺
抑扬	顿挫
抑止	遏止
抒怀	抒情
抒难	纾难	解危
抓住	捉住
抓耳挠腮	挠腮撧耳	搔头抓耳	搔头摸耳
投亲	探亲	省亲
投刺	进谒
投合	迎合	逢迎	承颜候色	阿谀奉承	攀援	攀附	攀龙趋凤	高攀	凑趣	奉承	巴结	恭维	捧场	谄媚	谄谀	趋承	阿谀
投契	投机	谋利
投机倒把	投机取巧	生财有道	看风使舵	囤积居奇	操奇计赢	操奇逐嬴	奇货可居	待价而沽
投递	送达
抖擞精神	磨砺以须	磨刀霍霍	刀光剑影	金鼓连天	金鼓齐鸣	枪林弹雨	烽火连天	刀光血影	一触即发	剑拔弩张	千钧一发	杀气腾腾	箭在弦上
折中	折衷
折冲尊俎	折冲樽俎
折磨	熬煎
折辱	挫辱	摧辱
抚今悼昔	抚今追昔	谈古论今
抛摆	抛撇
抛清	撇清
抛荒	荒疏
抠心挖肚	搜肠刮肚
抢手	热点	热门
护理	照顾护士五光十色
报告	汇报	请示
披发左衽	披发文身	被发左衽
披头散发	蓬首垢面	蓬头垢面	垢面蓬头	不修边幅	囚首垢面	披发散缨	被发缨冠
披览	披阅	拆阅
披露	暴露	流露	表露	露出	袒露
披麻带孝	拖麻拽布
抬高	举高
抱不平	行侠仗义
抱头	捧头	捧首
抱头大哭	抱头痛哭
抱歉	歉仄	报歉	抱愧	摰友	谢罪	负疚	赔礼	抵偿	补偿	赔偿
抱火卧薪	抱火寝薪
抵死漫生	抵死谩生	殚智竭虑	绞尽脑汁	冥思苦想	千方百计	挖空心思	苦思冥想	左思右想	巴前算后	思前想后	想方设法	搜肠刮肚	费尽心机	处心积虑	殚思极虑	殚精竭虑
抵牾	矛盾
押解	押送
抽丁拔楔	拔丁抽楔
抽暇	抽空	抽闲
抽象	笼统
拂晓	破晓	黎明	平旦	平明
拂衣	拂袖
拂面	掠面
担惊受怕	耽惊受怕	心惊胆战	悬心吊胆	提心吊胆	闻风丧胆	惊恐万状	胆战心惊	人心惶惶	惶惶不安	失张失智	心神不定	大惊失色	瞠目而视	怛然失色	大吃一惊	惊诧万分	不寒而栗	心惊肉跳	毛骨悚然	面如土色
担水	挑水
拆东墙补西墙	拆东补西
拆伙	搭伙	散伙	分伙
拆字	测字
拆牌道字	拆白道字
拉家带口	拖儿带女
拌合	拌杂	搀合	搀和	搀杂
拍手	鼓掌
拍浮	泅水	游泳
拍照	摄影	照相
拍马屁	捧臭脚
拐骗	棍骗	欺骗	诈骗	诱骗	诳骗
拒人于千里之外	拒人千里	距人千里	不近人情	冷若冰霜	通情达理	不省人事	不知甘苦	不知疼痒	不知痛痒	麻木不仁	木人石心	铁石心肠	心如铁石	木石心肠	我行我素	泥塑木雕
拒却	断绝	间断	阻遏	阻隔	隔离
拒狼进虎	拒虎进狼
拔出	插入
拔取	选取
拔地倚天	拔地参天
拔山举鼎	拔山扛鼎	拔山盖世	拔山超海
拔帜树帜	拔赵帜易汉帜
拔来报往	速来速往
拔类超群	拔萃出类	拔萃出群
拔苗助长	揠苗助长	欲速不达	适得其反	急功近利	深谋远虑
拔锚	起锚
拔除	根除	清除	铲除	革除	打扫	扫除	清扫	拂拭	断根	肃清	解除	取销	废弃	废除	撤废	排除	破除
拖人下水	拖人落水
拖拉	拖沓	疲塌
拖泥带水	滞滞泥泥	牵丝攀藤	婆婆妈妈	连篇累牍	连编累牍	累牍连篇	繁文缛节	附赘悬疣	联篇累牍	长篇大论
拘奇抉异	搜奇猎异
拘捕	拘系	逮捕
拙嘴笨脑	笨口拙舌	笨嘴拙舌	笨嘴笨舌	钝口拙腮	拙口钝腮	拙口钝辞	拙嘴笨舌	拙笨	笨拙	蠢笨	屈曲	愚昧	愚笨	愚蠢
拙笔	秃笔
拙见	管见	鄙见
招兵买马	招降纳叛	拉帮结派	结党营私	植党营私	官官相卫	朝里无人莫做官	朋党比周	阿党比周	阿党相为
招安	招抚
招惹是非	招风惹草	招风揽火
招招手	挥挥手
招聘	雇用
拜别	离去
拜将封侯	拜相封侯
拜年	贺年
拜把兄弟	换帖兄弟	结拜兄弟
拜访	造访
拜鬼求神	求神拜鬼	求神拜佛
拟订	订定	凌云壮志	志薄云霄
拣精拣肥	挑三拣四	拈轻怕重	避重就轻	挑肥拣瘦	声东击西	避实就虚	避难就易	避难趋易	出奇制胜	暗渡陈仓
拣选	挑撰	采选
拥书南面	拥书百城
拥堵	拥挤
拨云撩雨	拨雨撩云
拨弄	盘弄
拨弄是非	搬唇弄舌	搬唇递舌	拨乱视听	造谣生事	飞短流长	流短蜚长	流言蜚语	耳食之言	风言风语	人言可畏	人言籍籍	人言藉藉
拨浪鼓	货郎鼓张惶失措	仓皇失措	七手八脚	手足无措	不知所可	不知所措	心慌意乱
拨草寻蛇	自找麻烦
择要	摘要
拯民水火	解民倒悬
拾金不昧	路不拾遗
拾零	鳞爪
拿三搬四	拿腔作势	拿腔做势	装模作样	拿班作势	拿班做势	拿糖作醋	捉班做势	装腔作势	拿腔作调	矫揉造作	气壮如牛	色厉内荏
持久	耐久	临时	历久	恒久	暂时	长久	长期
持之以恒	铁杵成针	铁杵磨成针	锲而不舍	始终如一	坚持不懈	坚持不渝	坚韧不拔	勤学不辍	孜孜不倦	孳孳不息	始终不渝	愚公移山	一如既往	自始自终	一以贯之	善始善终	始终不懈	有始有终	自始至终
持疑不决	持疑不定
持盈保泰	持盈守成
持重	稳健	肃肃	轻佻	轻快	轻捷	轻盈	切当	失当	得当	恰当	妥当	适合	适当	妥善	妥贴	安妥	就绪	稳当
挂一漏万	涓滴不露
挂号	注销	登记
挂彩	挂花	负伤	鼻青眼肿	鼻青脸肿
挂念	牵挂	牵记	记挂	挂心	挂记
按例	照例
按功行赏	酬功给效
按劳分配	无功受禄	不劳而获	坐享其成	坐收渔利
按序	顺次	依次	序次	次序	次第	按次	挨次	递次	顺序	动作	方式
按捺不住	按纳不住
按摩	推拿
挑拨离间	推涛作浪	搬弄是非
挑选	筛选	遴选
挑逗	撩拨
挖耳当招	自作多情
挟天子以令天下	挟天子以令诸侯
挡住	盖住
挤眉弄眼	龇牙咧嘴
挥汗如雨	汗出如浆	汗如雨下	汗流浃背	挥汗成雨	汗流满面	浃背汗流
挥泪	洒泪
挥洒自如	洋洋万言	洋洋大观	洋洋洒洒	蔚为大观	鸿篇巨制
挨家挨户	挨家逐户	挨门挨户	挨门逐户	司马昭之心	路人皆知	家喻户晓	门到户说	众所周知	妇孺皆知	人所共知	尽人皆知	无人不晓	有目共睹	享誉中外	家弦户诵
挪动	挪移	移动
挪动转移	搬动
挪用	调用
振弱除暴	锄强扶弱	吊民伐罪	抑强扶弱	杀富济贫	除暴安良	除残去秽
振臂一呼	登高一呼
挺拔	高耸	魁梧	挺秀	特立
挺拔伟岸	笔直粗壮
挺身而出	毛遂自荐	自告奋勇	急公好义	见义勇为	慷慨仗义	仁至义尽	体贴入微	关怀备至	嘘寒问暖	无微不至
捆扎	系缚
捉拿	缉捕	访拿	跴缉	踩缉
捋臂张拳	蠢蠢欲动	跃跃欲试	伎痒	技痒	捋臂将拳	摩拳擦掌	揎拳掳袖
捕快	探员
捕捉	捕获
换班	调班	转班
换衣	易服	更衣
捣毁	摧毁
捧住	端住
捷报频传	节节胜利
掂量	权衡	衡量
掇臀捧屁	溜须拍马	阿谀奉承	奴颜婢膝	奴颜媚骨	卑躬屈膝	卑躬屈节	吮痈舐痔	曲意逢迎	阿谀奉迎	卖国求荣	卖身投靠	媚外求荣	趋炎附势	里通外国	乞哀告怜	摇尾乞怜	崇洋媚外	摇尾乞食	摧眉折腰	胁肩低眉	胁肩低首	胁肩谄笑	巴高望上	攀龙附凤	接贵攀高	攀高结贵
授课	讲课
掉队	落伍
掐尖落钞	雁过拔毛
排出	架空
排斥异己	排除异己
排演	排练
排解	排遣
排闼	推门
掠影浮光	浮光掠影	蜻蜓点水	走马看花	走马观花	时刻不忘	记忆犹新	每饭不忘	不痛不痒	轻描淡写	马上看花
探友	访友
探寻胜迹	访古寻幽
探望	探访	看望	追寻	打听	拜望	拜谒	访候	探询	探问
探究	探索	摸索	试探
探询	探问
接头	群情	讨论	议论	评论辩论	谈论
接应	策应	接管	收受
接洽	联系	交涉	会商	会谈	商洽	构和	漫谈	计议	谈判	会见	参见	拜会	拜候	拜见	拜访	接见	访谒	访问	会晤	会面	碰面	谋面
接踵	相继
推动	鞭策	功德	勉励	好事	激劝	激励	煽动	鼓动	鼓励	鼓舞	怂恿	煽惑
推却	辞谢
推寻	推求
推崇	推许
推脱	推诿
推让	辞让	忍让	推辞	礼让	谦让
推销	采购	倾销	洽购
推陈出新	除旧更新	除旧迎新	推陈布新	花样翻新	除旧布新	除残去秽	革故鼎新	吐故纳新	喜新厌旧	送旧迎新	新陈代谢	弃旧容新	破旧立新	舍旧谋新	兴利除弊	涤故更新	移风易俗	送往迎来	送故迎新
掩盖	笼盖	覆盖	掩饰笼罩	袒护
掩耳盗铃	自欺欺人	弄巧成拙
措辞	言语	语言	说话
掮客	经纪
提及	说起
提拔	拔擢	倡始	抬举	提升
提示	提醒
提纲	提要	撮要	概要
插翅难逃	插翅难飞	束手无策	搏手无策	无计可施	走投无路	大刀阔斧	大马金刀	雷厉风行	在劫难逃	在所难免	劫数难逃	坐以待毙	安坐待毙	束手待毙
握手言欢	重归于好
握拳透掌	握拳透爪
揣合逢迎	阿谀逢迎	投其所好	阿其所好	阿谀奉承	谄谀取容	阿世取容	阿意取容	阿谀取容	阿谀谄媚
援军	救兵
揽辔澄清	揽辔登车
搅浑	混同	混杂	混淆	稠浊	同化	夹杂	异化	殽杂	混合
搏斗	斗争	格斗	肉搏	屠杀	残杀
搜捕	缉拿
搜查	查抄	查看	检查
搪瓷	珐琅
搬场	搬家	搬迁	迁居
搬斤播两	盘剥克扣
搭架子	摆架子
搭钮	铰链
搴旗取将	搴旗虏将
携手	联袂
携手合作	合力进行
摆布	支配	安排	安插	安放	安置	安装	安设	安顿	布置	搁置	放置	装配	部署
摆设	装备	设备	设施	设置	配备	配置	装置
摇摇摆摆	摇摇晃晃
摇摇欲坠	风雨飘摇
摇钱树	钱树子
摈除	撵走	听从	驱散	驱赶	驱逐
摊开	放开	铺开	摊平	铺平
摔倒	跌倒	颠仆
摧心剖肝	摧胸破肝
摧残	残害	践踏	糟踏	浪费	糟蹋	糟践	蹂躏
从命	听命	固守	坚守	奉行故事	恪守	服从	遵从	遵命	遵守	遵守习惯	制服	屈从	屈就	屈服	征服	礼服	顺从	顺服	驯服
摧身碎首	粉身碎骨	齑身粉骨	战死沙场	马革裹尸	决一死战	杀身成仁	糜躯碎首	肝脑涂地	赴汤蹈火	身首异处	浴血奋战	迎头痛击	短兵相接	背水一战	孤注一掷	背注一掷	一决雌雄	决一雌雄	群雄角逐
摩厉以需	摩厉以须	摩砺以须
撑肠拄肚	撑肠拄腹
撒娇撒痴	撒痴撒娇
撒手尘寰	溘然长逝
撒泼	撒野
撤离	撤退	退却	后退	猬缩
播种	收获	收成
撮合山	月老祠
撺拳拢袖	擦拳磨掌	擦掌磨拳
擅自	私自	私行
操之过急	稳扎稳打	步步为营	事缓则圆	从长计议	放长线钓大鱼
擎天一柱	砥柱中流	中流砥柱	坚如磐石	坚定不移	架海金梁	国家栋梁	力挽狂澜	扭转乾坤
擎天撼地	震天撼地
攀亲	结亲	联姻
攀爬	攀登	攀缘
攀辕卧辙	遮道挽留
支支吾吾	期期艾艾
收容	收留
收容所	栖流所	难民营
收拾整顿	整理	整顿	清理	清算
收据	收条
收缩	缩短	膨胀
收集	网络
改动	改变	窜改	篡改	回旋	扭转	旋转	盘旋	改善	改良	改进	刷新	变动	变卦	变换	变更	变革	改观	改造	改革	更动	更始	更改	调动	调换	调用	转变
改名	更名
改换	更换	替换	互换	换取	调换	交换
改朝换代	改步改玉	改玉改步	改玉改行	乔装打扮	文过饰非	涂脂抹粉	傅粉施朱	改头换面	面目一新
改组	改选
改过	自新
攻其不备	攻其无备	出人意外	出其不备	出其不意	出奇制胜	出敌不意	出敌意外	声东击西	出乎意外	出乎意料	出人意料	出人意表	出乎预料	不期然而然	不期而然
攻城掠地	攻城略地
放手	松手	甩手	罢休	撒手
放晴	转晴
放火	纵火
放火烧山	煽风点火
放纵	放荡	汗漫	狂放	纵脱
放肆荒唐	胡天胡地
放荡不羁	放荡任气	倜傥不羁	放浪形骸	放荡形骸
政以贿成	贿赂公行	货赂公行
政清狱简	政简刑清
故乡	故土	故里	桑梓
故交	故人	故友
故入人罪	深文周纳	深文罗织
故园	故宅	故居	故舍
故意刁难	百般刁难
故旧	素交
效力	效劳	效能	任事	供职	做事	办事	处事	就事	干事	服务	管事
敏捷	迅速
救急	济急
救火员	消防员
救生衣	浮水衣
敖不可长	欲不可从
教师	西席
教练	熬炼	磨炼	锤炼	锻炼	锻练
敛声屏气	敛色屏气
敝帚千金	敝帚自珍	爱惜羽毛	自惜羽毛
散乱	零乱	狼藉
散兵游勇	残兵败将	残军败将	人强马壮	兵强马壮	五大三粗	头遇到一位	孔武有力	身高马大	人多势众	羽毛丰满	羽翼已成
散失	流失	消失	消散	消逝	磨灭	隐没
散步	漫步	闲步
散逸	闲逸
敦实	矮壮
敬爱	爱戴
敬礼	施礼	行礼	还礼	见礼
敬终慎始	谨小慎微	小心翼翼	小心谨慎	谨言慎行	不寒而栗	毛骨悚然	毛骨竦然	毛骨耸然	胆战心惊	战战兢兢
敬而远之	敬若神明	若即若离	不即不离	半推半就	势合形离	貌合神离	同床异梦	貌合情离
数典忘祖	邯郸学步	东施效颦	里丑捧心	鹦鹉学舌	优孟衣冠	学步邯郸	亦步亦趋	人云亦云	步人后尘	矮人看场	矮子看戏
数白论黄	论黄数白
数目	数量
敲榨勒索	软硬兼取	敲骨吸髓	横征暴敛	苛捐杂税	仗势欺人	刮骨吸髓	巧取豪夺	敲诈勒索
敲竹杠	敲诈勒索	敲骨吸髓	横征暴敛	苛捐杂税
敲诈	讹诈	欺诈
整军经武	整军饬武
整装	束装
敷衍了事	敷衍塞责	因循苟且	聊以塞责	苟且偷生	苟全性命	苟延残喘	马马虎虎	苟且偷安	草间求活	自甘堕落	得过且过	聊以卒岁
文人起义	秀才造反
文化	文明
文君新寡	文君早寡
文如其人	言为心声
文字	笔墨	翰墨	文句	词句
文意	辞意
文房四宝	纸墨笔砚	文房四士
文案	案牍
文过饰非	讳疾忌医	掩罪藏恶	拒谏饰非	涂脂抹粉	独断专行	闭门造车
斑点	雀斑	黑点	斑纹	花纹
斑白	花白
斗南一人	旷世一人
斗筲之人	斗筲之器	斗筲之辈
料中	猜中
料峭轻寒	春寒料峭
斥退	斥革	革退
斥逐	解散	遣散
斥骂	诃斥
斩尽杀绝	杀人如麻	灭绝人性	血债累累	血海深仇	赶尽杀绝	灭门绝户	剪草除根	斩草除根	翦草除根	诛尽杀绝	消灭净尽	鸡犬不留	一干二净	寸草不留	一网打尽	除恶务尽	削株掘根	抱蔓摘瓜	片甲不留	顺藤摸瓜
斩钉截铁	斩钢截铁	刀切斧砍	含糊其辞	直截了当	支吾其辞	闪烁其辞	隐约其辞	直言不讳	合盘托出	和盘托出	畅所欲言	言无不尽	百无禁忌	童言无忌	开门见山	直抒己见	肆无忌惮	随心所欲
断井颓垣	断垣残壁
断发文身	断发纹身
断壁残垣	断壁颓垣
断子绝孙	绝子绝孙
断念	死心
断气	气绝
断送	葬送	就义	捐躯	舍身
断魂	销魂
新仇旧恨	深仇大恨	血海深仇	情天孽海	以牙还牙	复仇雪耻	报仇雪恨	报仇雪耻	报怨雪耻	咬牙切齿	瞋目切齿	恨之入骨	深恶痛绝	痛心疾首	刻骨仇恨	恨入骨髓	不共戴天	你死我活	势不两立	誓不两立	嫉恶如仇	疾恶如仇	深恶痛疾	食肉寝皮	切齿痛恨	鸳入骨髓	切齿腐心
新力量	生力军
新婚燕尔	洞房花烛	燕尔新婚
新居	新房
新愁旧恨	旧愁新恨付之一炬	付之丙丁	付诸东流	毁于一旦
新月	月牙
方向	标的	目的	倾向	偏向	偏差	方针	目标
方士	术士
方外之人	方外之士
方巾气	道学味
方正	朴直	梗直	耿介	高洁	廉洁
方法	要领	举措	办法	措施	法子	设施	门径
施主	檀越
施助	赈济
施医	赠医
旁观	观看	赏玩	寓目	察看	窥察	考察	观察	观测	视察	调查	作壁上观	冷眼旁观	袖手旁观	隔岸观火	查询拜访	调治
旅客	游客
旗头	旗手
旗帜鲜明	爱憎分明
旗开得胜	百战百胜	马到成功	水到渠成	战无不胜	所向无敌	攻无不克	锐不可当	降龙伏虎	所向披靡	百战不殆	立于不败之地	一帆风顺	无往不利	无往不胜	无坚不摧	望风而逃	望风披靡
无一不知	无所不知	无所不通
无丝有线	无私有弊
无为	有为
无可争辩	无可置疑	无可置辩	半信半疑	将信将疑	疑信参半	千真万确	确切不移	不容置疑	信而有征	有凭有据
无可非议	未可厚非	情有可原	无可厚非
无名小卒	马前卒	无名英雄	无名鼠辈	芸芸众生
无地自容	汗颜无地	无处藏身	问心有愧	愧汗怍人
无奈	无法
无尽无休	没完没了	无休无止
无巧不成书	无巧不成话
无影无踪	渺无影踪	渺无踪影	烟消云散	荡然无存	九霄云外
无微不至	无所不至	为所不为	无所不为	无所不可	华盖云集	宾至如归	门庭若市	亲如家人	关怀备至	无所不知	满腔热情	车水马龙	马如游龙	马龙车水	门庭如市	络绎不绝	臣门如市	毂击肩摩	门可罗雀	人山人海	熙来攘往
无忧无虑	自由自在	逍遥自在	无思无虑	无牵无挂	清心寡欲	安枕无忧	高枕无忧	高枕而卧
无恶不作	极恶穷凶	穷凶极恶	罪恶滔天	无所不为	作恶多端	凶神恶煞	如狼似虎	伴食中书	伴食宰相	妖魔鬼怪	混世魔王	暴戾恣睢	为所欲为	暴虐无道	横行霸道	荒淫无度
无情无义	绝情寡义
无懈可击1	自作掩饰	自圆其说	天衣无缝	无懈可击	滴水不漏2
无所事事	鸿鹄之志	四体不勤	四体不勤，五谷不分	饱食终日	听天由命	无所作为	无所用心	坐以待毙	束手就擒	束手待毙	束手无策
无所适从	进退两难	进退失据	骑虎难下	不知所措	进退维谷
无拘无束	自由自在	安闲自在	挥洒自如	行家里手	训练有素	龙飞凤舞	笔底生花
无故	无端
无望	有望
无本之木	无源之水	无米之炊
无法计算	难以估计
无用之材	道旁苦李	道边苦李
无知	蒙昧
无稽之谈	耳食之论	耳食之谈	不经之谈	奇谈怪论	海外奇谈	道听途说	胡言乱语	胡说八道	不根之谈	流言蜚语	人言可畏	积毁销骨	一人传虚，万人传实	三人成虎	众口铄金	以讹传讹	讹以滋讹
无穷	无量	无限
无足轻重	秋毫之末	轻于鸿毛	不屑一顾	置之不顾	置若罔闻	鄙夷不屑	举足轻重	事关全局	大有可观	不急之务	细枝末节	无关紧要	腹背之毛
无边	无际
无边风月	风光迤逦
无阻畅通	畅通无阻
无隙可乘	有机可乘	有隙可乘	无孔不入	见缝就钻	乘虚而入	趁虚而入	乘隙而入	乘人之危	攻其不备	浑水摸鱼	混水摸鱼	趁火打劫	墙倒众人推	破鼓万人锤	落井下石
无须	毋庸
既成事实	木已成舟	覆水难收	反水不收	泼水难收	嫁鸡随鸡，嫁狗随狗	令出必行	驷不及舌	驷马难追
日上三竿	日已三竿	半夜三更	三更半夜	深更半夜	夜阑人静	更深人静	万籁俱寂	夜深人静	夜静更深
日不暇给	日夜操劳	日无暇晷	日理万机	案牍劳形	应接不暇	目不暇接	席不暇暖	一馈十起	夙夜不懈	宵衣旰食	握发吐哺	旰食宵衣
日中则昃	盛极必衰	月盈则食	物极必反	否极泰来	时来运转	乐极生悲	否去泰来	苦尽甘来
日出三竿	日高三丈	红日三竿
日夕	早晚	迟早
日夜	昼夜
日就衰败	每况愈下	一泻千里	一落千丈	不能自拔	今不如昔	江河日下	自暴自弃	日甚一日	日暮途穷	每下愈况
日志	日记
日旰忘食	日旰忘餐
日曜日	星期日
日月入怀	明月入怀
日进斗金	财运亨通
日间	白天	白日	白昼
旦角	花旦
旧梦重温	破镜重圆	重温旧梦	坠欢重拾	言归于好	和好如初
旧调重谈	老生常谈	老调重弹	陈词滥调	旧事重提	旧话重提	因循守旧	墨守成规	故步自封	泥古不化	蹈常袭故	食古不化	旧瓶装新酒	旧调重弹	抱令守律	抱残守缺	拘俗守常	萧规曹随
早安	晨安
早霞	朝霞
旭日	朝阳
旱季	雨季
时不再来	时不我待	不失时机	可乘之机	待机而动	机不可失	可乘之隙	岁不我与
时事	时势	时局
时代	时期	期间
时光虚掷	马齿徒增	马齿徒长
时势所迫	格于环境	被迫	形格势禁
时尚	时髦
时局动荡	沧海横流	祸乱滔天
时时刻刻	每时每刻	无时无刻
时机	机会	机缘	机遇
时来运转	苦尽甘来	鸿运高照	否极泰来	苦尽甜来	雨过天晴	云消雾散	烟消云散	云开日出	雨后初霁	雨过天青	偃旗息鼓	匿影藏形	销声匿迹	鸣金收兵	冰消瓦解	化为乌有	涣然冰释	灰飞烟灭	烟消火灭	如鸟兽散	风流云散	付之东流	无影无踪	荡然无存	销声敛迹	隐姓埋名
旷世奇才	旷世逸才
旷古绝伦	空前绝后	绝无仅有	举世无双	亘古未有	史无前例	盖世无双	无与伦比	无可比拟	前所未有	得未尝有	得未曾有	绝世超伦	举世无敌	举世无比	兵强马壮	战无不胜	所向披靡	无往不胜	寡二少双	当世无双	独一无二
旷夫怨女	痴男怨女
旷课	缺课
昂昂自若	昂然自若	昂然直入	昂然而入	卬首信眉	昂首伸眉
昂然挺立	昂首挺立
昂首挺胸	昂首阔步	高视阔步	神气活现	昂头天外	昂首天外
昂首阔步	气宇轩昂	高视阔步	高视睨步
昆虫	虫豸	虫子
明亮清明	明朗	晴明	清朗
明天	明日
明如指掌	明察暗访	明察秋毫	明查暗访	明若观火	洞若观火	洞察其奸	洞烛其奸	了如指掌	了若指掌	管窥蠡测	一清二楚	一目了然	一览无余	尽收眼底	不言而喻	显而易见	不问可知	一望而知	高深莫测	一览无遗	一览而尽	洞察一切
明婚正娶	明婚正配	明媒正娶	明媒正礼
明扬仄陋	明扬侧陋
明效大验	明验大效
明火执仗	明火执杖	明目张胆
明示	昭示
明窗净几	窗明几净	安室利处
明辨是非	是非分明	井水不犯河水	是是非非
昏头昏脑	昏昏欲睡	晕头转向	委靡不振	无精打采	有气无力	浑浑噩噩	糊里糊涂	胡里糊涂	迷迷糊糊	无缘无故	没头没脑	混混沌沌	不明不白	模糊不清	含糊不清	暧昧不明
昏定晨省	晨昏定省
昏瞶	颟顸
昏镜重明	昏镜重磨
昏黄	朦胧
星散	松散	疏松	蓬松	分别	分手	分散	分离	分袂	别离	告别	告辞	拆散	涣散	离别	离散	辞别	辞行	疏散	握别
星斗	星辰
星期	礼拜
星期四	木曜日
星河	河汉	银河	天河
星火燎原	水滴石穿	燎原之火	磨铁成针	积习沉舟	心坚石穿	星星之火	功到自然成	水磨工夫	磨杵成针	磨穿铁砚	绳锯木断	铁杵磨成针	路遥知马力，日久见人心
映托	映衬
春事阑珊	春意阑珊
春光	春景	春色
春光如海	春深似海
春光漏泄	泄漏春光	春光外泄	漏泄春光
春冰虎尾	虎尾春冰
春去夏来	春去秋来
春宫	秘戏图	春心	春情
春雨如油	春雨贵如油
昭雪	翻案	平反	申雪
是日	此日	这天
是曲	曲直
是非曲直	是非黑白	青红皁白	青红皂白	大是大非
显要	贵显	贵要	显达	闻达
显贵	权贵
显赫	煊赫
显露出	透出	表露	显露	流露	透露	吐露	泄漏	泄露	走漏	发挥	施展	暗示	示意	表示	阐发	默示	发扬	阐扬	表现
晋用楚材	楚材晋用	楚才晋用
晓得	知道	了解
晓行夜住	晓行夜宿
晓风	晨风
晓风残月	青灯古佛
晖映	照射	照耀
晚世	近世
晚年	暮年	晚景	暮景	老景
晤面	见面
晦涩	艰涩	难懂	难明	难解
晨光	晨曦
晨兴夜寐	起早贪黑
普度众生	普济群生	普渡众生	仗义疏财	博施济众	慷慨解囊	打富济贫	扶弱抑强	杀富济贫	锄强扶弱	扶危济困
景色	风光	风景	风物	体面	面子
景象形象	气冲牛斗	气吞山河	气壮山河	气贯长虹	怒发冲冠	气冲霄汉	气涌如山	义薄云天	正气凛然	气势磅礴
晴天霹雳	青天霹雳
智尽能索	江郎才尽
智慧	聪明	高明	高超
暖洋洋	热乎乎
暖锅	火锅
暗号	暗记	灯号	记号	旌旗	旗号	旗帜
暗室亏心	暗室欺心
暗度陈仓	暗渡陈仓	暗送秋波	眉来眼去	眉目传情	眉语目笑	眼去眉来	脉脉传情
暗影	阴影
暗杀	暗算
暗沟	阴沟
暗流	暗潮
暗淡无光	黯淡无光	黯然失色	黯然无光	黯然无色	相形失色	相形见绌	大相径庭	每况愈下	等而下之
暗盘	黑市
暗笑	窃笑
暗箭中人	暗箭伤人	暗箭难防
暗里	私下
暗香疏影	疏影暗香
暮气	朝气	生意盎然	生机蓬勃	生气勃勃	郁郁葱葱	朝气蓬勃	生机勃勃
暮秋	深秋
暮鼓晨钟	金口木舌	暮鼓朝钟
暴乱	暴动
暴政	虐政
暴殄天物	煮鹤烧琴	煮鹤焚琴
曲堤	曲岸
曲折小路	羊肠小道	崎岖小道
曲解	误会	误解
曳尾涂中	苟且偷生
更上一层楼	更进一竿
更头	更次
更深人静	更深夜静
更鼓敲尽	铜漏滴尽
曾参杀人	流言可畏
曾经沧桑	饱经忧患	饱经沧桑	饱经霜雪	饱经风霜	曾经沧海	见多识广	饱经世故
替人	替身
最少	起码
最近	比来	近日
最高级	第一流
月亮	玉轮	玉盘	婵娟	玉兔	冰轮	玉桂	冰镜	广寒宫	嫦娥	月球	蟾蜍	桂魄
月尾	月底
月晦	月终
月白风清	清风明月	月光如水	月明如镜	月明星稀	月朗星疏
有口难言	有口难辩	有苦难言	有口难分	难言之隐	百辞莫辩
有夫之妇	罗敷有夫
有头有尾	有始有卒	有始有终	善始善终	好头不如好尾	一脉相承	一脉相通	前因后果	来龙去脉
有棱有角	棱角分明
有求必应	来者不拒
有生之年	耄耋之年
有的放矢	见兔放鹰	对症下药	隔靴搔痒	因材施教
有眼不识泰山	有眼无珠	视而不见	听而不闻	熟视无睹	充耳不闻	视若无睹	闭关自守	闭目塞听	冷眼旁观	漠不关心	漠然置之	袖手旁观	闭目塞聪
有脚阳春	阳春有脚
有言在先	有言在前
有进无退	济河焚舟	过河拆桥	获兔烹狗	过桥抽板	兔死狗烹	鸟尽弓藏	卸磨杀驴	翻脸无情
朋分	瓜分	豆割	分割	宰割	支解
服役	退役
服膺	谨记
服饰	衣饰
望女成凤	望子成龙	老牛舐犊	舐犊情深	爱子心切	舐犊之爱
望尘拜伏	望尘而拜
望而却步	望而生畏	侧目而视	怒目而视	远而避之	退避三舍	听天由命	畏葸不前	知难而退
望衡对宇	衡宇相望	门当户对
望见	看见	瞥见
望风希指	望风希旨
朝上进步	进取
朝夕与共	朝夕相处	朝夕共处
朝晨	清早	早晨	晚上	清晨
朝朝暮夕	朝朝暮暮
朝过夕改	朝闻夕改
朝闻夕死	朝闻夕没
期求	祈求
木匠	木工
木屋	板屋
木排	木筏
木料	木材	木柴
木本	草本
木樨	桂花
木炭	柴炭
末了	末尾	末端	着末	结尾
本义	转义
本人	本身	自己	自身
本原	本源	来源	根基	根源	泉源	源头	起原	基础	根底	根本	根蒂	原形	基本	本相	根柢
本子	簿子	簿本
本末倒置	爱毛反裘	舍本求末	轻重倒置	舍本逐末	舍近求远	贪小失大	拔本塞原	拔本塞源	捐本逐末	主客不分	冠履倒易	冠履倒置	本末颠倒	剖腹藏珠	因噎废食	买椟还珠	倒果为因	反裘负薪	因小失大	颠倒是非	反裘负刍
本能机能	职能
术数	法术	神通
朱紫	贵人
朱门	豪门	权门
朱颜	红颜
局部	部分
机关	机构	部门
机动	灵活
机密	秘密	秘要
朽木不可雕	朽木不雕	朽木难雕
朽木粪土	朽木粪墙
杀人不眨眼	杀人不见血
杀身成仁	舍生取义	视死如归	奋不顾身	舍生忘死	成仁取义	舍身殉难	从容就义	以身殉职	以身许国	肝脑涂地	舍身成仁
杀风景	煞风景
杂居	混居
杂念	邪念
杂沓	混乱	紊乱	错乱	交融	冗长	杂乱	烦复	芜杂	融会	融合	庞杂	繁芜	复杂	庞大	庞大无比	庞然大物	硕大无朋	纷乱	错杂
权利	权力	权柄	权益	职权
权宜之策	权宜之计	缓兵之计
权术	霸术	机谋	权略	权谋
权衡轻重	比权量力
杆格不入	格格不入	自相矛盾	方枘圆凿	水火不容	扞格难入	水乳交融	心心相印	心领神会	息息相通	冰炭不洽	势不两立	水火不相容	冰炭不同器	冰炭不投	冰炭不相容	不共戴天	令人切齿	你死我活	唇齿相依	誓不两立	鱼死网破
杏眼圆睁	柳眉倒竖
杏脸桃腮	杏腮桃脸	柳眉星眼
材伎	材艺
村塾	村学	村校
村夫野老	村野匹夫	凡夫俗子	常鳞凡介	村夫俗子	伧夫俗人	平常百姓	大千世界	芸芸众生	等闲之辈	绸人广众	肉眼凡夫	肉眼凡胎
村子	村落	乡村	农村	墟落	屯子	村庄
杜康	狂药
杜撰	诬捏
杜渐防微	杜渐防萌	防微杜渐	有备无患	防患未然	一时之需	不时之须	备而不用	及早防备	未雨绸缪	有恃无恐	养儿防老	积谷防饥	曲突徙薪	以防万一	以防不测	养军千日，用在一时	养兵千日，用兵一时	器二不匮
杜绝	根绝
杞天之忧	鳃鳃过虑
束之高阁	置之高阁	置诸高阁	漠然置之	熟视无睹	置之不理	置之度外	置若罔闻	不了了之	充耳不闻	听而不闻	视而不见	视若无睹	不闻不问	漠不关心
束厄局促	束缚	约束
条分缕析	言之有序
条则	条文
条款	条目
条记	笔记
来之不易	谈何容易
来日诰日	翌日
来迎去送	迎来送往
杯中之物	杯中物
杯水之敬	杯水之谢
杯觥交杂	杯觥交错
杯酒解怨	杯酒言欢
杳杳无踪	鸿飞冥冥
极刑	死刑	死罪
极点	顶点
极目	纵目
极重	綦重
构成	组成	形成	造成
枕山栖谷	枕流漱石	枕石漱流
林下风度	林下风气	林下风范
果决	果断	武断
果然	果真
枢路	要津
枯坐	闲坐
枯窘	窘蹙	贫窭
枵腹	空腹
枷锁	枷锁束缚	桎梏	镣铐
柏舟之节	柏舟之誓
柔柔	柔滑	轻柔
柔肠寸断	柔肠百结	柔肠百转	肝肠痛断
柔能克刚	齿亡舌存	齿敝舌存
查办	查究	核办	追究	深究	清查	究查	穷究	追查
查察	检察	稽察	稽查
查对	核对	核查	审阅	核阅	审视	扫视	批阅
查无实据	没根没据
查考	覆按
查询	查问	盘问	盘诘
查验	检验	测验	考试
柴毁骨立	爱毁骨立	骨瘦如柴	脑满肠肥	大腹便便	心宽体胖	心广体胖	小家碧玉	掌上明珠	窈窕淑女	养尊处优	娇生惯养	纸醉金迷	花天酒地	肠肥脑满	荣华富贵	金玉满堂
标志	标记	标识	符号	表记	标帜
标题	题目	成绩	标题问题	问题	了局	后果	成就	成效	成果	效果	结果
栏杆	雕栏
树德	立德
树怨	结怨
树模	树范	示范
树碑立传	歌功颂德
栖息	栖身
校对	校正	校阅
校短推长	校短量长
株式会社	股份有限公司
样式	款式
根本治理	正本清源	正本澄源	端本正源
根深蒂固	深根固柢	深根固蒂	盘根错节	错综复杂	积习难改	积重难返	坚不可摧	本固枝荣	根深叶茂	犬牙交错	犬牙相制	纵横交错	错落有致	长短不一	扑朔迷离	参差不齐	错落不齐	搀前落后	良莠不齐	参差错落
格调	派头	作风	景物	景致	气势	气概	风格	声势	声威	家数	心怀	心胸	气宇	气度	气派	气焰	气量	气魄	派别	派系	流派	阵容	魄力
桃李不言，下自成行	桃李不言，下自成蹊
桃李满天下	桃李遍天下	遍布天涯
案卷	档册	檀卷	檀案
桑枢瓮牖	蓬门荜户	蓬户瓮牖
桑榆暮景	风烛残年
桑田	沧海
档次	品位
梁上君子	穿窬之盗	旁门左道	鸡鸣狗盗	鼠窃狗偷	鼠窃狗盗
梢公	海员	舵手	船员	水手
梯山航海	登山渡海	仆仆风尘	到处奔走	四处奔波	奔走风尘	抗尘走俗	翻山越岭	跋山涉水	风餐露宿	航海梯山	风尘仆仆	不辞劳怨	不辞劳苦	不辞辛苦	不远千里	千里迢迢	孜孜不倦	废寝忘食	摩顶放踵
梵衲	沙门	头陀
检阅场	演武厅
棘地荆天	荆天棘地
棘手	随手	顺手
楚云巫雨	楚天云雨
楚挞	笞打
楚楚动人	楚楚可人
楚河汉界	楚界汉河
楞手楞脚	粗手粗脚
概念	观念	观点
榜书	署书
槁项黄馘	面黄肌瘦	脸黄肌瘦	面有菜色
樊笼	牢笼
模型	模子
模摸糊糊	模模糊糊	隐隐约约	影影绰绰
横扫千军	风卷残云
横死	非命
横生枝节	节上生枝	节外生枝	加油加醋	添油加醋	好事多磨	添枝加叶	添枝接叶	枝节横生	有枝添叶
横眉冷目	横眉冷眼
横眉怒目	横眉竖眼	呲牙咧嘴	青面獠牙	凶相毕露	虎视眈眈	面目狰狞	其势汹汹	杀气腾腾	气势汹汹	气焰嚣张	肆无忌惮
横蛮	野蛮
横队	纵队
樵苏不爨	樵苏失爨
橙黄桔绿	橙黄橘绿
欠债	负债
欠缺	短缺	空虚
次日	越日
重建	重修	修缮
欢乐无比	长乐未央
欢呼雀跃	欢喜若狂	欢欣若狂	活蹦乱跳	活蹦活跳	手舞足蹈	欢蹦乱跳	载歌载舞	抚掌大笑	欢天喜地	欢欣鼓舞
欢声笑语	语笑喧阗
欢声雷动	鸦雀无声	喜气云腾	欢声如雷
欢然	陶然
欢迎	欢送
欧化	西化
欧美	泰西	西洋
欲取故予	欲擒故纵	诱敌深入	严阵以待
欺上瞒下	欺上罔下
欺君犯上	欺君罔上
欺善怕恶	欺大压小	欺弱怕强	吐刚茹柔	欺软怕硬	吃硬不吃软
歃血为盟	沥血以誓	对天盟誓
歌乐	笙歌
歌扇	舞裙歌扇
正人君子	正派人物	志士仁人	耿介之士
正言正谏	直言无隐	直言正论
正路	正途	正道
此伏彼起	此起彼伏
此次	这次
步伐	步调	步骤	法度	法式	程序	形势	形式	情势	模式
步兵	步卒
步步生莲花	莲花步步生
步碾儿	步行	步辇儿
步线行针	环环紧扣
歧途	邪路	邪道
歪七扭八	歪歪扭扭
死乞白赖	死求白赖
死亡	殒命	灭亡
死后	身后
死搬教条	生搬硬套	郑人买履
死路	绝路末路
殃及池鱼	池鱼之殃	池鱼之祸	无妄之灾	不测之忧	不测之祸	飞来横祸	飞灾横祸
殊效	特效
残余	渣滓	剩余	残存	残剩
残忍不仁	残暴不仁
残杯冷炙	残羹冷炙	残羹剩汁	残羹剩饭	残茶剩饭
残虐	肆虐
毁家纾难	精忠报国	舍身为国	尽忠报国	赤心奉国	赤心报国
毁林	造林
母仪	母范
母大虫	母老虎
母财	母钱
每日	逐日
毒害	迫害	凌虐
毒杀	鸩杀
毒草	香花
毒酒	鸩酒
比及	等到
比年	近年	连年	频年
比目连枝	比翼连枝
比肩叠踵	比肩叠迹
比赛	竞赛	角逐
毕竟	究竟结果	终究
毗连	毗邻	连接	邻接
毛发丝粟	毫发丝粟
毛笔	羊毫
毫无所惧	肆无忌惮	任性妄为	妄作胡为	混淆是非	黑白分明	为非作歹	横行霸道	胡为乱做	胡作非为	鱼肉乡里	专横跋扈	为所欲为	横行无忌	蛮横无理	悍然不顾	专断	独断	作威作福	倒行逆施	恣行无忌	盛气凌人	耀武扬威
民脂民膏	民膏民脂
民贼独夫	独夫民贼
气味	气息
气宇轩昂	神气十足	英姿勃勃	英姿飒爽	高视阔步
气昂昂	雄赳赳
气氛	氛围	空气
水上人家	浮家泛宅	流离失所	流离转徒	造次颠沛	颠沛流离	浪迹江湖	无家可归	沦落风尘	流离颠沛	流落他乡	流落失所	流离颠顿	流离转徙	浪迹天涯	妻离子散	家破人亡	离乡背井
水乳交融	浑然一体	天衣无缝	难分难解
水兵	水师	海军
水到渠成	瓜熟蒂落	顺理成章	迎刃而解	任其所为
水可载舟，亦可覆舟	载舟覆舟
水天一线	水天相接
水平	程度
水患	水灾
水来伸手，饭来张口	衣来伸手，饭来张口
水果	生果
水池	池塘
水沟	水渠	沟渠
水清无鱼	水至清则无鱼
水滴	水点
水脚	水费	船脚
水货	舶来品	进口货
永世	永久	永恒	永远
永别	永诀
永劫	长时
永夜	长夜
永日	长日
永生	长生
求亲告友	求亲靠友
求同存异	求大同，存小异
求情	讨情	说情
求田问舍	问舍求田
求神问卜	求签问卜
汉子	男人	男子汉大丈夫
江山好改，本性难移	江山好改，秉性难移	江山易改，秉性难移
池沼	沼泽
污名	臭名
污吏	贪吏
污流	浊流
污浊	浑浊	混浊
污秽	腌臜
汲汲忙忙	汲汲皇皇
汹涌澎湃	波澜壮阔	声势浩大	烈烈轰轰	轰轰烈烈	云蒸霞蔚	气势磅礴	气壮山河	气象万千	浩浩荡荡	令行禁止	兴师动众	大动干戈	大张声势	大张旗鼓	大打出手	大气磅礴	气吞山河	雷厉风行	调兵遣将	口诛笔伐	大力声讨	大张挞伐	短兵相接	龙争虎斗	气贯长虹
汽锅	锅炉
沃土	瘠田	膏壤
沃田	肥田
沉博绝丽	沉博艳丽
沉吟不语	沉默寡言	默不做声	默默无言	沉静寡言
沉思	深思	寻思	覃思
沉李浮瓜	浮瓜沉李
沉溺	沦落	堕落
沉灶产蛙	沉灶生蛙
沉甸甸	轻飘飘
沉疴宿疾	疑难杂症
沉睡	觉醒	甜睡	酣睡	熟睡
沉默	缄默	沉静
沏茶	泡茶
沐浴	洗浴	洗澡
沐猴而冠	没毛大虫	衣冠禽兽	马牛襟裾	人头畜鸣	人面兽心	狼心狗肺	行同狗彘	群丑跳梁	群魔乱舞	为鬼为蜮	无耻之徒	牛鬼蛇神	社鼠城狐	胡作非为	魑魅魍魉	封豕长蛇	毒蛇猛兽	妖魔鬼怪	牛头马面	马面牛头
沙岸	沙滩
没可奈何	没法奈何
没大没小	没轻没重	目无尊长
没没无闻	籍籍无名	默默无闻	无声无息	无声无臭	不声不吭	不声不响	默不做声	寂寂无闻
沥胆堕肝	沥胆披肝	丹成相许	丹诚相许	披肝沥胆	肝胆照人	肝胆相照	推诚相见	诚心诚意	碧血丹心	赤子之心	赤胆忠心	忠心耿耿	耿耿忠心	耿耿此心
河东狮吼	畏妻如虎	河东狮子吼
河伯	河神
河干	河滨	河畔	河边
河流	河道
河涸海干	河落海干
河鱼之疾	河鱼腹疾
沸水	滚水
油头滑脑	油腔滑调	嘻皮笑脸	油嘴滑舌	虚头滑脑
治丝益棼	理丝益棼
沿波讨源	追本溯源	顺藤摸瓜	拔树寻根	追根究底	追本求源	追本穷源	寻根究底	蔓引株求	蔓引株连	寻本挖源	寻踪觅迹	搜根剔齿	刨根问底
泄漏天机	透露机密
泄电	漏电
泉币	货币	货泉	钱币	钱银
法眼	高眼
法纪	纲纪
法门	秘诀
泛动	涟漪	激荡	荡漾
泛滥	浩繁	众多	浩瀚
泛起	荡起
波及	涉及	触及
波浪	海浪	波涛	波澜
泣下如雨	泣涕如雨	泪如雨下	涕泗流涟	泪下如雨
泥坑	泥塘	泥淖
泥沙俱下	牛骥同皁	牛骥同皂	鱼龙混杂	名不副实	掩人耳目	滥竽充数	鱼目混珠	老婆当军
泥首	顼首
注水	灌水
注目	瞩目
泯没	淹没消灭
泯灭	淹灭
泰山压卵	狮子搏兔	以卵击石	自不量力	蚍蜉憾树	螳臂当车	卵与石斗	夸父追日	夸父逐日	不自量力	以卵投石	螳臂挡车	量力而行	蚍蜉撼树	蜉蝣撼树
泰然自若	神色不惊	行若无事
泼天大胆	胆大如斗	浑身是胆	胆大包天	小心谨慎	蹐地局天	步步为营	稳扎稳打	谨言慎行	胆小如鼠	一丝不苟	一毫不苟	临深履薄	兢兢业业	提心吊胆
洋火	火柴	磷寸
洋蜡	白蜡	地蜡	白腊	石蜡
洋装	西服
洒洒潇潇	潇潇洒洒	落落大方	雍容大雅
洒脱	超脱	超逸
洗手不干	脱胎换骨	改邪归正	洗心革面	换骨夺胎	改过自新	革面洗心
洗礼	浸礼
洗雪	湔雪
洞天福地	蓬瀛仙境	蓬莱仙境	世外桃源	名山大川	名山胜川	名山胜水	名胜古迹	锦绣河山	桃源胜境	福地洞天
洞居	穴居
洞穴	洞窟	窟窿
津润	润泽	润泽津润	滋养	滋润
津贴	补助	补贴
洪水猛兽	祸不单行	灾患丛生	避坑落井	避阱入坑	雪上加霜
活力	生机
活埋	生坑
活扣	活结
活捉	生擒
活该	该死
活路	活门	生路
流亡	逃亡	遁迹	避难
流散	漂泊	漂流	飘泊
流水不腐，户枢不蝼	流水不腐，户枢不蠹
流行	风行	风靡	盛行
流言	空名	谰言
浃髓沦肌	浃髓沦肤
浅色	淡色
浅薄	浅陋	陋劣	微薄	浮浅	菲薄	单薄
浇灌	灌溉
浏览	抚玩	旅行	观赏	参观	观光	鉴赏
浑水摸鱼	趁火打劫	乘人之危	落井下石	趁人之危	趁火抢劫
浑浑噩噩	浑浑沌沌	混混噩噩	混混沌沌	迷迷糊糊	糊里糊涂	胡里糊涂	昏昏沉沉
浑身	满身
浓艳	冶艳	浓妆
浩叹	长叹	长吁	对天长叹	长吁短叹	唉声叹气	喟然而叹	豪言壮语	向隅而泣	咳声叹气	垂头丧气	无精打采	穷途末路
浩大	浩荡	昌大	盛大
浩饮	狂饮	猛饮	痛饮
浪人	游勇
浪子	荡子
浪潮	海潮
浪荡	游荡
浪迹浮踪	浪迹萍踪	萍踪浪迹
浮名	虚名
浮皮潦草	浮皮蹭痒
浮荡	飘荡	沉没	流浪	流离	漂浮	漂荡	落难	飘扬	飘流	飘零	吞没	淹没	覆没
浮言	蜚言
浴池	混堂
海域	海疆
海水	淡水	咸水
海水不可斗量	海水难量
海阪	海隅
浸渐	积渐
浸透	渗入	渗透
消溶	溶化	熔解
消融	溶解	融化
消退	衰退	阑珊
涉水	渡水
涕泗横流	涕泗滂沱	痛哭流涕
涕泣	涕零
涤瑕荡垢	涤瑕荡秽
润滑	滑润	光滑	圆滑	油滑	滑腻	平滑	腻滑	世故
涸池而渔	焚林而猎	焚林而田
淌下	滴下
淡泊明志	淡然处之
淡然	漠然
淡然置之	满不在乎	等闲视之	无动于衷	麻木不仁	麻痹不仁	不动声色	无动于中	掉以轻心	满不在意	漠不关心	漫不经心	漫不经意	若无其事
深信	笃信	坚信
深入显出	深入浅出
深刻	简易	粗浅	深入	深切	深化
深厚	深挚	深沉	深邃深挚
深奥无极	渺不可测
深居简出	足不出户	走南闯北	离群索居	闭门谢客	闯南走北
深沟壁垒	深沟高垒
深耕易耨	精耕细作
深邃	高妙	高深	深奥	艰深
混名	花名	诨名
混水摸鱼	蒙混过关
混闹	胡闹	厮闹
清冷	清凉
浅易	浅显	浅近
清心寡欲	清心少欲	清静寡欲
清新	清爽
清洗	荡涤	洗涤	洗濯
清点	盘点	盘货
清算计帐	算帐	计帐
清苦	清贫	穷困	贫困	贫寒	贫穷	贫穷困难	贫苦	贫无立锥	一文不名	一贫如洗	家徒四壁	清瘦	清癯
清茶淡饭	饭糗茹草
清规戒律	说一不二	金口玉牙	金口玉言	金科玉律	颠扑不破	因循守旧	墨守成规	泥古不化	食古不化	一言为定	言而有信	说一是一，说二是二	说一是一	一诺千金	划一不二	言行一致	大权在握	大权独揽	一手包办	一手遮天	力排众议	无可争辩	一言堂	独断专行	政由己出
清高	狷介
渔翁得利	鹬蚌相争	渔人之利	渔人得利	你死我活	势不两立	誓不两立	以死相拼	鱼死网破
温文尔雅	温柔敦厚	温良俭让	温良恭俭	温良恭俭让	和蔼可亲	蔼然可亲	慈眉善目	和颜悦色	平易近人	一团和气	冬日可爱	和风细雨
温饱	饥寒
渲染	衬着
游移	踌躇	迟疑	夷由	犹疑	犹豫	愚钝	痴顽	徐徐	缓缓
游蜂戏蝶	游蜂浪蝶
游览	翱翔	遨游	飞翔	飞行	巡游	旅游
游记	纪行
渺无人烟	渺无人踪	渺无人迹	荒无人烟
湛蓝	蔚蓝
湿润	潮湿
湿淋淋	湿漉漉
源源而来	滔滔而至	源源不绝	绵绵不断	源源不断	源远流长	取之不尽，用之不竭	无穷无尽	接连不断	此起彼伏	此起彼落	络绎不绝	连绵不断
源远流长	积厚流光
溜冰	滑冰
溺死	灭顶
滋长	生殖	繁殖	繁衍
滑头	狡徒
滑稽	诙谐	有趣	风趣	乏味	幽默	滑天下之大稽	滑稽可笑
滑稽突梯	诙谐百出
滔滔	滚滚
滚存	结存
滚开	滚蛋
满山遍野	漫天遍地	漫山遍野	铺天盖地	星罗棋布	浩如烟海	排山倒海	遮天盖地	遮天蔽日	倒海翻江	回山倒海	翻江倒海	移山倒海	翻天覆地
满腹狐疑	满腹疑团
满足	餍足
漂动	飘拂
漆黑一团	黑灯下火	黑灯瞎火	不见天日	暗无天日	漫漫长夜	豺狼塞路	豺狼当道	长夜漫漫	长夜难明	天昏地暗	昏天黑地	神志不清	惨无天日	地老天荒	天荒地老	寸步难行	荆天棘地	雷虐风号	飞沙走石	旷日持久	经年累月	长年累月	长此以往	天长日久	遥遥无期
漏掉	脱漏	遗漏
演化	演变
演练	练习	训练
漫天开价	漫天要价	漫天讨价	瞒天要价	瞒天讨价
漫无止境	漫无边际	茫无边际	人心不足蛇吞象	贪心不足	得寸进尺	得陇望蜀	贪猥无厌	软土深掘	贪得无厌	唯利是图	损人利己	据为己有	见利忘义	尖酸刻薄	雁过拔毛	欲壑难填
漫空	长空
漫笔	随笔
漱流枕石	漱石枕流
潜移默化	耳濡目染	潜移暗化	近朱者赤	耳熟能详	耳闻目睹	近朱者赤，近墨者黑	熟能生巧	耳闻则诵
潢池弄兵	潢池盗弄
潮水	潮流
澈底	透澈
澎湃	磅礴	彭湃	汹涌
澜倒波随	随波逐流	同流合污	见风使舵	随声附和	与世浮沉	趁波逐浪	同恶相济	狼狈为奸	随俗浮沉	互相标榜	相互吹嘘	相互捧场	党同伐异	官官相为	官官相护	朋比为奸	沆瀣一气
激动慷慨	激昂	鼓动感动
激怒	激愤
激战	酣战	鏖战	苦战
灌注	灌注贯注	灌输	贯注
火中取栗	徒劳无益	水中捞月	竹篮打水	敝鼓丧豚	作嫁衣裳	依人篱下	耕人之田	为丛驱雀	为渊驱鱼	敲冰求火	缘木求鱼	求道于盲	钻冰取火	钻冰求火	钻火得冰	问道于盲	吹影镂尘	劳而无功	徒劳往返	心劳日拙	江河日下	徒劳无力	枉费心机	海底捞月	海底捞针	白费心血
火伞高张	烈日当空
火化	火葬
火树银花	灯火辉煌	灯烛辉煌	张灯结彩	火树银光
火油	煤油
火热	炎热	炽烈	炽热	酷热
火药	炸药
灭门刺史	破家县令
灯泡	灯胆
灯炷	灯芯
灯红酒绿	酒池肉林	酒绿灯红	醇酒妇人	十丈软红	花花世界	纸醉金迷	花天酒地	醉生梦死	煞费苦心	费尽心血	呕心沥血	处心积虑	挖空心思	殚思极虑	殚智竭力	殚精竭虑	竭尽心思	穷奢极欲	冥思苦想	熬心费力
灯蛾扑火	自投罗网	飞蛾赴火	自取灭亡	自坠陷阱	自掘坟墓	飞蛾扑火	不自量力	以卵投石	以指挠沸	无济于事	咎有应得	咎由自取	罪有应得	自作自受	自食其果	自讨苦吃	惹火烧身	招灾惹祸	引火烧身	玩火自焚
灰头土脸	灰头土面
灵通	通晓	通达
灵魂	魂魄
灾害	灾祸	灾难	磨练	磨难	考验
灾黎	难民
炊火	烟火	炎火	烈焰	炙烤	烧灼	火把	火炬
炮凤烹龙	烹龙炮凤
炮竹	爆仗	爆竹
炳如日星	炳若日星
点头哈腰	诺诺连声	连连称是	点头	颔首	拍板
点头答应	颔首应承
点火	焚烧	燃烧
点石成金	点铁成金
点金作铁	点金成铁
烂若披锦	烂若舒锦
烂醉如泥	玉山颓倒	酩酊大醉	酩酊烂醉
烈火真金	疾风知劲草
烘托	衬托	陪衬
烛炬	蜡烛
烦琐	繁缛
烧毁	销毁	焚毁
烧琴煮鹤	焚琴煮鹤	大煞风景	背山起楼	兴致索然	败兴而归
烧饭	煮饭
热心	热情
热潮	飞扬	飞腾	高涨	高潮
热爱	酷爱
热闹	繁华	富贵	荣华	贫贱
烹调	烹饪
烽火	烽烟	狼烟	战火
焕然一新	耳目一新
焚书坑儒	焚典坑儒
焚劫	焚掠
焚膏继晷	通宵达旦	夜以继日	连日继夜	连日连夜	熬更守夜	日以继夜	夙兴夜寐	废寝忘食	起早摸黑	起早贪黑
焦灼	焦虑
焦眉愁眼	焦眉苦脸
煞有介事	盛气临人	目中无人	矫揉造作	盛气凌人	锋芒毕露	锋芒逼人
照功行赏	论功行赏	按劳计酬	计功行赏
照映	辉映
熊腰虎背	虎背熊腰
熏陶	陶冶
熔今铸古	熔古铸今
熟习	熟悉	相熟	熟练	纯熟	谙练	闇练
熬清受淡	熬清守淡
燕侣莺俦	燕俦莺侣
燕雀处堂	燕雀处屋
爬山	登山
爬泳	自由泳
爬罗剔抉	精挑细选
爬虫类	爬行动物
爱人好士	爱才好士
爱国如家	爱民如子	视民如伤
爱如己出	视如己出
爱生恶死	贪生怕死	贪图享受	贪生畏死
爱素好古	阿时趋俗
爱鹤失众	玩物丧志
父老	长者	先辈	先进	前辈	尊长	晚辈	进步前辈	长辈
爽利	爽快	爽气爽直	爽直	干脆	快人快事	爽性	直言快语
片子	电影	影戏
片断	片段
片瓦不留	片瓦无存
片面之言	片面之词
牌坊	牌楼
牛山濯濯	草木不生
牛溲马勃	败鼓之皮	马勃牛溲
牛饮	豪饮
牝牡	雌雄
牢不可破	颠扑不破	坚不可摧	不刊之论	勿庸置疑	无可辩驳	铁板一块	不易之论	不易之典	千真万确	天经地义	理所当然
牲口	畜生	六畜	家畜	牲畜
牵强附会	穿凿附会	瓜熟蒂落	顺理成章	望文生义	顾名思义	断章取义
牵挂捆扎	系念
牵累	缠累	株连	牵连	连累	关涉	带累	干连	扳连	拖累	牵涉	牵缠	瓜葛	纠葛	轇轕	牵扯
牵线搭桥	穿针引线
牵肠挂肚	春树暮云	儿女情长	朝思暮想
犁庭扫穴	直捣黄龙	深入虎穴	势如破竹	长驱直入	摧枯拉朽	破竹之势	秋风扫落叶	不堪一击	一触即溃	势单力薄	外强中干
犯得上	犯得着	犯的上
犯忌	犯讳	犯禁	违禁
犯法	犯罪	犯科	犯警
犹豫不定	迟疑不决	迟疑未决
狂喝豪饮	酒后耳热	酒酣耳热
狂暴	狞恶
狂风暴雨	飘风暴雨	急风暴雨	暴风骤雨	疾风暴雨	暴风疾雨
狂风暴雪	风雪交加
狐臭	腋臭
狗仗人势	驴蒙虎皮	仗势欺人	欺人太甚	逼人太甚	有恃无恐	吊民伐罪	恃势凌人	狐假虎威	除暴安良
狗彘不若	猪狗不如
狗洞	狗窦
狡辩	诡辩
独创	首创
独占	独有
独居	茕居
独立	自力
独立国	自主国
狭小	狭窄	狭隘
狼奔鼠窜	鼠窜狼奔
猎取	获取	得到
猛将	虎将	英雄
猜拳	豁拳
猥琐	鄙陋
猪朋狗友	酒肉朋友	狐朋狗友	酒肉兄弟
獐头鼠目	蛇头鼠眼	其貌不扬	贼眉鼠眼	言语无味	面目可憎
玄门	道教
玉人	美女	玉体	贵体	尤物	美人
玉帛	财宝	财帛	钱财	产业	家产	家当	工业	财产	财富
玉液琼浆	金樽旨酒
王侯	贵爵
王侯将相	达官贵人	公卿大臣	皇亲国戚	高官厚禄	衮衮诸公	达官显宦	土豪劣绅
王婆卖瓜	老王卖瓜
王孙公子	贵族子弟
环绕纠缠	缠绕
环视	环顾
现状	近况
玷污	玷辱
珍奇	珍异
珠光宝气	翠绕珠围	华冠丽服	峨冠博带
珠圆玉润	肌理丰盈
珠宫贝阙	贝阙珠宫
理屈词穷	词穷理尽	词穷理屈	目瞪口呆	瞪目结舌	哑口无言	缄口不言	不见经传	张口结舌	无名鼠辈	无声无息	默默无闻	爱口识羞	碍口识羞	闭口不言
琐屑	零碎
琐屑零星	鸡零狗碎
琳琅满目	美不胜收
瓮中之鳖	釜底游鱼	鱼游沸鼎	鱼游釜中
甘甜	甜美	甜蜜
甘薯	番薯
甘雨	甘霖
甜言	蜜语
甜言蜜语	糖衣炮弹	肺腑之言	花言巧语	冗词赘句	滔滔不绝	空洞无物	长篇大论	长篇累牍	伶牙俐齿	对答如流	巧舌如簧	巧言令色	拨是弄非	摇唇鼓舌	出口成章
生养	生育
生存	生活	生计	糊口生涯
生性	素性
生息不断	生生不已
生机勃勃	活泼	活跃	生动	兴致勃勃	兴趣盎然
生死关头	紧要关头
生灵涂炭	苍生涂炭	荼毒生灵	水深火热	水火倒悬	坐于涂炭	国困民艰	民穷财尽	民不聊生	水火之中	啼饥号寒	饥寒交切	饥寒交迫	哀鸿遍地	哀鸿遍野	饿蜉载道
生番	蛮人
生疏	目生	陌生
生离死别	遗恨千古
用处	用途
用度	费用
田单	田契
田猎	野猎
田鸡	青蛙
由由然	飘飘然
甲板	船面
甲由	蟑螂
申诉	申说	申述
电光石火	稍纵即逝	弹指之间	日不移晷	曾几何时	转瞬之间	好景不长	昙花一现	过眼云烟	好景不常
电扇	风扇
画图	绘图
画情诗意	诗情画意
畅快	痛快	酣畅	舒坦	利落	坦直	爽脆	直爽	索性	直率
畅通	疏通	通顺	疏浚	畅达	通畅	通行
畅销	脱销
畅饮	酣饮
界限	边界	鸿沟
留任	蝉联	连任
留宿	过夜
略微	稍微
略胜一筹	稍逊一筹	聊胜一筹
番笕	肥皂	胰子
疏财仗义	重义轻财
疑惑不解	迷惑不解
疑问	疑难
疼痛	痛苦悲伤
疾苦	痛楚	痛苦
疾驶	缓行
病国殃民	祸国殃民	欺君误国
痕迹	遗迹	陈迹	遗址
痛心	酸心
痛念	轸慕
痛苦不堪	苦不可言	苦不堪言	回头是岸	芒芒苦海	苦海无边	茫茫苦海
痴情	薄情
痴肥	臃肿
痴钝	缓慢	迟缓	迟钝
瘠薄	贫瘠
瘦骨嶙峋	鸡骨支床	如不胜衣	弱不禁风	弱不胜衣	手无缚鸡之力	质似薄柳	软弱无力	形容枯槁	面黄肌瘦	鸠形鹄面	鹄形菜色	形销骨立	瘦骨伶仃	骨瘦如柴	消瘦	瘦弱	瘦削
登高望远	高瞻远瞩	八面玲珑	眼观六路	八面见光	八面驶风	左右逢源	见风使舵	面面俱到	面面俱圆	八面张罗	一叶障目	只见树木，不见森林	目光短浅	鼠目寸光	孤陋寡闻	目光如豆	目光如鼠	驽马恋栈豆
白净	白皙
白发	鹤发
白手	空手	赤手
白手起家	自力更生	自给自足	自食其力	各自为政	独立自主	自立门户	一国三公	各行其是	政出多门	各自为营	各不相谋	步调一致	不相为谋	各谋其是
白搭	白费	空费
白璧微瑕	美中不足
白种人	碧眼儿
白驹过隙	驹光过隙
百发百中	百步穿杨	穿杨射柳	矢无虚发	弹无虚发	剑无虚发	策无遗算	箭不虚发
百家争鸣	百花怒放
百密一疏	鸭蛋虽密也有缝
百舍重茧	百舍重趼
百花争妍	繁花似锦	姹紫嫣红	满园春色	花红柳绿	仪容俊秀	如花似玉	如花似锦	花容月貌	万紫千红	花团锦簇	花枝招展	落英缤纷	出水芙蓉	初发芙蓉	绝代佳人	沉鱼落雁	闭月羞花	国色天香	秀外慧中	秀色可餐	窈窕淑女	羞花闭月	倾城倾国	花颜月貌	天香国色	天姿国色
百足之虫，死而不僵	百足之虫，至死不僵
百身何赎	百身莫赎
百闻不如一见	耳听为虚，眼见为实	耳闻不如目见	眼见为实	耳听为虚
的当	确当
的确	确实	几乎	切实其实	简直	险些
皋比	虎皮
皓齿明眸	聪明伶俐
皮囊	皮郛
皮相之见	皮相之谈
盈余	盈利	红利
盎盂相击	盎盂相敲
监工	督工	管工
监禁	监管	羁系
盖世太保	秘密警察
盖印	盖章
盗取	窃取	偷取
盗怨主人	盗憎主人
盗首	盗魁
盘查	盘考	究诘
盘游	般游
盘盘大才	过人才略
盘算	策画	计算	计较	谋略	较量争论	对比	对照	斗劲	比力	比拟	比照	比较	角力	较量	相比
盘蹲	箕踞
盛情	盛意	美意
盛极一时	风行一时	风靡一时	不翼而飞	无翼而飞	不胫而走	不知去向	石沉大海	无影无踪	杳无音信	渺无音信	渺无音讯	泥牛入海
盛装	艳服
目使颐令	目指气使	凭几据杖
目光	眼光
目光如炬	目光如电	炯炯有神	目光炯炯
目击	目睹	眼见
目力	目力眼光	眼力	视力
目即成诵	过目不忘	过目成诵	一目十行	一览成诵	目下十行
目录	目次
目擩耳染	目染耳濡	耳擩目染	耳染目濡	见闻习染
目无法纪	目无王法	无法无天	天高皇帝远	作奸犯科	横行霸道	胡作非为	以身试法	知法犯法	违法乱纪
目炫	目眩	眼花	目眩心花	目眩神摇	目眩神迷	目眩神驰	目眩魂摇
目若悬珠	目若朗星
目迷五色	眼花缭乱	五彩缤纷	头昏眼花	头昏脑眩	头昏脑胀	头晕目眩	应接不暇	扑朔迷离	目不暇接
盲人	瞽者	盲眼	瞎眼
盲人摸象	盲人说象	以蠡测海	持蠡测海	以管窥天	以锥刺地	坐井观天	管窥蠡测	窥豹一斑	管中窥豹	管窥所及	井底之蛙	尺泽之鲵	不识大体	目光如豆	鼠目寸光	小廉曲谨	放饭流歠	可见一斑	管窥一斑	窥见一斑	井蛙之见	一孔之见	一得之功	一得之愚	一得之见	一隅之见
盲风怪雨	盲风暴雨
直情径行	随心所欲	为所欲为	自得其乐
直言敢谏	面折庭争	面折廷争	祸发齿牙	多言买祸	多言招悔
直言贾祸	祸从口出	言多必失	齿牙为祸
直通	纵贯
相交	订交
相似	类似
相反相成	相辅相成	皮之不存，毛将安附	皮之不存，毛将焉附	相得益彰
相当	相称	相等	感恩戴德
相惊伯有	自相惊扰
相机行事	见几而作	见机而作	见机行事	见机而行	争分夺秒	分秒必争	只争朝夕	朝干夕惕	细针密线	细针密缕	见缝插针	朝兢夕惕
相知恨晚	相见恨晚	相识恨晚
相逢	邂逅	重逢
省会	省垣	省城
省吃俭用	节衣缩食	断齑画粥	一丝不苟	克勤克俭	精兵简政	精打细算	缩衣节食	布衣疏食	缩衣节口	艰苦朴素
省察	省检
眉开眼笑	眉花眼笑	眉飞色舞	笑逐颜开	眉欢眼笑	眉飞眼笑	喜怒哀乐	悲欢离合	离合悲欢	酸甜苦辣	加膝坠渊	喜形于色	喜怒无常	喜眉笑眼	笑容可掬
眉目	端倪
看人行事	见人行事
看家本事	看家本领
看朱成碧	看碧成朱
看风使舵	看风使船	见风使舵	通权达变	随机应变	因地制宜	对症下药	就地取材	有的放矢	本山取土	因势利导	顺水推舟	因利乘便	借坡下驴	借风使船	回船转舵	见机行事	深厉浅揭	相机行事	因时制宜	量体裁衣	入乡随俗	入境问俗	入竟问禁
真个	端的
真假	虚实
真心	至心	诚意
真心实意	诚心诚意	一心一意	全心全意	坦怀相待	开心见诚	推心置腹	肝胆相照	贴心贴腹	目不斜视	目不转睛	目不邪视	全神贯注	目无流视	聚精会神	专心一志	专心致志	专心一意	坐不窥堂	心无二用	心无旁骛	目不窥园	屏气凝神	收视返听	一心一意	专一	全心全意
真挚	诚挚	朴拙	真诚	竭诚
真知灼见	远见卓识	崇论宏议	崇论闳议	别具只眼	别具慧眼	自出机杼	真理	真谛
真金不怕火	真金不怕火炼
眠花宿柳	眠花藉柳
眸子	眼珠
眼中钉	肉中刺
眼帘	视线
眼观六路，耳听八方	眼观四处，耳听八方
眼高手低	空腹高心
着着失败	节节失利
睥睨	顾盼	傲视
瞎扯	瞎说	空话	假话
瞒天过海	谩天昧地
瞒神弄鬼	装神弄鬼
瞠目结舌	面面相看	面面相觑
矛头	锋芒
矜持	自持
矢口否认	矢口抵赖
矢言	矢誓	矢语发誓
矢语	起誓	赌咒	发誓	宣誓	立誓
知己知彼	知彼知己	举棋若定	胸有成竹	指挥若定	稳操胜券	成竹在胸	心中有数
知心	贴心
知情达理	通情达理
知止不辱	知足不辱
知疼着热	知疼着痒
知趣	识相
知过必改	知过能改	过而能改
知音难觅	高山流水
矫枉过正	过犹不及	挢枉过正	过为己甚
短吃少穿	饥寒交迫	聊以卒月	艰苦卓绝	艰难竭蹶
短小精悍	简明扼要	要言不烦	言简意赅	言近旨远	删繁就简	不蔓不枝	持之有故	文从字顺	言之有理	顺理成章	言之有物	言简意少	有案可稽	有闻必录	合情合理	有凭有据	理直气壮	言之成理	言必有据
短少	缺少	穷乏	贫乏
短跑	长跑
石匠	石工
石崇之富	邓通之财	陶猗之富
石本	碑帖	碑本
码头	船埠
研究	研讨	钻研
砥砺	镌刻	雕刻	雕琢	雕镂
砰然	轰然
破涕为笑	转悲为喜	破颜一笑
破耗	破费	破钞	花费	支出
砺世摩钝	砺世磨钝
确乎不拔	确固不拔
碍手碍脚	触手碍脚
碍难从命	碍难遵命
碧绿	苍翠	葱翠	葱茏	葱郁
碰到	碰着	碰见	遇见
挣脱	摆脱	解脱
碰运气	试试看
磊瑰不羁	磊落不羁
磬竹难书	难更仆数	数不胜数
磷火	鬼火
示威	请愿
礼坏乐崩	礼崩乐坏
祈祷	祷告
祝愿	祝福
神不知鬼不晓	神不知鬼不觉
神州大地	赤县神州
神差鬼使	神差鬼遣	鬼使神差	铸成大错	阴差阳错	一差二错	一念之差	差之毫厘
神机妙算	锦囊妙计	灵丹圣药	灵丹妙药	能掐会算
神经病	精神病
神色	神采
神采奕奕	精彩逼人
神韵	韵味
神龙见首	神龙见首不见尾
祭奠	祭祀
祸害	祸患	祸殃
祸根	祸端	祸胎
祸福倚伏	祸福相依
祸福同门	祸福无门
禀承	遵奉
禁暴诛乱	禁暴静乱
福不重至	福无双至
福分	福气	福泽	福寿无疆	福寿绵绵	福寿绵长
福寿膏	阿芙蓉
离开	脱离
离隔	间隔	隔断	隔绝	隔绝距离	隔膜
禽兽不如	蝇营狗苟
私交	私情
私人	私家
私意	私衷
私相授受	秘密交易	私运	走私
私语	耳语	密语
私货	黑货
秋天	秋日	秋天景色	秋景	秋风	金风抽丰
秋蓬	转蓬	飘蓬
秋风团扇	秋风纨扇
种别	类别
种瓜得瓜	种豆得豆
种花	莳花	种田	耕田
科头赤足	科头跣足
秘而不言	秘而不露
积善	积德	行善
积极	踊跃
积毁销骨	铄金毁骨
积羽沉舟	群轻折轴	蚁穴溃堤	聚蚊成雷	丛轻折轴	众口铄金
称号	称呼	称说	称谓
称孤道寡	称王称帝	孤家寡人	横行霸道	独断专行	独霸一方	称王称霸	飞扬跋扈
称心快意	遂心如愿	心满意足	称心如意	称心满意	得偿所愿
称柴而爨	称薪而爨
称王称霸	自封为王	黄袍加身
称许	赞许	赞同	附和	拥护	撑持	支持	支撑	拥戴
移东就西	移东补西
移天徙日	移天易日
移樽就教	移船就磡
稳妥	脸红	酡颜
稻粱谋	衣食计
稽首	顿首
穴见	肤见	粗见	浅见	漏见	鄙意	拙见
穷且益坚	穷当益坚
穷困落拓	裘弊金尽	裘敝金尽
穷寇勿迫	穷寇勿追
穷源溯流	穷源竟委
穷相	穷苦相	穷苦人	穷鬼	穷人	穷户	穷汉	贫民
空口白话	空口说白话
空言无补	纸上谈兵	徒托空言	托之空言	一纸空文	口惠而实不至	坐而论道	空头支票	虚无飘渺	绣花枕头	羊质虎皮	不着边际	华而不实	言之无物
空闲	闲暇	无事
穿戴	穿着	衣着
穿房入户	穿房过屋
穿梭	穿越
窃窃私议	窃窃私语	交头接耳	低声密谈
窘境	逆境	顺境
窜匿	逃匿
窜扰	窜犯
立此为证	立此存照
立足	驻足
竞渡	赛舟
竞走	赛跑
竟日	镇日
童叟无欺	老少无欺	公平买卖	公平交易	买卖公平	言无二价
竹篱	篱笆
竹苞松茂	美轮美奂
笑哈哈	笑嘻嘻
笔墨官司	笔枪纸弹	笔诛墨伐
笔战	舌战	激辩
笔走龙蛇	鸾翔凤翥	龙蛇飞动	龙蛇飞舞	龙飞凤舞	天马行空	挥洒自如	南征北战	纵横驰骋	转战千里
笔酣墨饱	笔饱墨酣
笨伯	笨蛋	蠢人	呆子	痴人	白痴	傻瓜
笨重	粗笨
轻巧	简便	轻便
笼中之鸟	笼中穷鸟	笼鸟槛猿
答案	谜底
答辩	问难	争吵	争持	争辩	斗嘴	申辩	辩论	辩说	争执	争论
筚门圭窦	筚门闺窦
签名	署名	签定	签署	签订
简略	简陋	简单
算无遗策	计划精巧
管房	茶房	酒保
管辖	统领
管鲍之交	陈雷之契
箪豆见色	芝麻绿豆
箴规	规戒	针砭	箴言	规语	忠告	忠言	针砭
篡位夺权	篡党夺权
簇拥	蜂拥
米珠薪贵	食玉炊桂
米饭钱	赡养费
粉妆玉琢	粉妆玉砌	粉装玉琢	粉白墨黑	粉白黛绿	粉白黛黑
粗拙	粗糙
粗放	集约
粗暴	粗犷
粗率	草率	轻率
粗疏	细致	过细	详尽	详细	具体
粗言	鄙言
粗躯	贱躯
粘皮带骨	粘皮着骨
粲花之舌	粲花之论
精力充沛	龙马精神
精华	英华
精妙入神	精妙绝伦	精美绝伦
精密	细密	严密	周密	周详	精巧	精细	精致	紧密	邃密	精美	缜密
精雕细刻	雕肝琢肾	刻章琢句	雕章琢句	咬文嚼字	雕章镂句	粗制滥造	偷工减料	敷衍了事	草草了事	草草收兵	句斟字嚼	之乎者也	字斟句酌	焉哉乎也	精益求精
糊涂难得	难得糊涂
糟糕	蹩脚
糟糠	荆布
素不相识	素昧生平	素昧平生	萍水相逢	冤家路窄	狭路相逢	不是冤家不碰头	不是冤家不聚头	不期而遇
素志	素愿
索债	讨债	讨帐
累块积苏	累苏积块
絮絮不休	絮絮叨叨	絮叨	罗唆
繁生	蕃殖
繁盛	繁茂	茂盛	闹热
繁荣富强	繁荣昌盛	兴旺发达	欣欣向荣	繁荣兴旺	隆隆日上	人寿年丰	丰衣足食	人给家足	国泰民安
纡青佩紫	纡青拖紫
红军	赤军
红彤彤	红艳艳
红男绿女	绿女红男
红色	赤色	血色
纤细	细微	轻微	轻细
纪年	编年
纪录	记实	记录	记载
纯净	单纯	地道	纯挚	纯正	纯洁	纯真	纯粹	贞洁	隧道	清纯
纳贡	进贡
纷繁	纷纭	纷纷	纷纷扬扬
线人	耳目
绅耆	缙绅
细目	详目
细软	金饰
终天之恨	终天之憾	终天之痛
终结	落幕	闭幕	终局	结局
绍述	继述
经世之才	经国之才	经济之才
经文纬武	经武纬文
经由过程	通过
经营	谋划	企图	打算	方案	策划	策动	筹划	筹算	筹谋	规画	计划	设计	妄想	希图	贪图	估计	估量	推算	盘算	意料	料想	预想	预料	预计
经过	颠末
经过议定	议决
结盟	缔盟	订盟
结驷列骑	结驷连骑
给与	授与
绚烂多彩	花花绿绿	绚丽	缤纷	壮丽	灿艳	烂漫
绝圣弃智	绝圣弃知
绝少分甘	绝甘分少
绝笔	遗嘱	遗言
绮绮子弟	绮襦纨裤
绳之以法	逃出法网	逍遥法外	依法从事
绳子	绳索
绳愆纠缪	绳愆纠谬
绳梯	软梯
绵力	薄材
绵薄	肤浅
绽开	绽放
绿林大盗	绿林强盗
绿林豪客	绿林豪杰	杀富济贫	绿林好汉	为民除害	劫富济贫	除暴安良	安良除暴	草头天子	草泽英雄	草莽英雄
绿鬓朱颜	绿鬓红颜
缄口不言	闭口藏舌	杜口	绝口	缄口	缄口不语	缄口无言	缄口结舌	缄口藏舌	钳口	闭口	闭口无言	三缄其口	道路以目	金人三缄	不可告人	守口如瓶	秘而不宣	讳莫如深	难以启齿	难言之隐	高深莫测	不赞一词	默不做声	忍气吞声	杜口吞声	秘而不露
缉获	缴获
编纂	编辑	编录	辑录
缝扣子	钉扣子
缠绵	缱绻	绸缪
缠足	裹足	扎脚
缩手缩脚	诸多忌惮	束手束脚	缩头缩脑	胆小慎微	束手束足	束手缚脚
缺吃少穿	缺吃短穿
缺漏	罅漏
罢了	而已
罪大恶极	罪恶昭着	罪恶滔天	罪该万死	十恶不赦	罪不容诛	罪孽深重	罪贯满盈	死有余辜	恶贯满盈	恶积祸满	死不足惜	无法无天	桀骜不驯	横冲直撞	横行无忌	横行霸道	为所欲为	为非作歹	恣意妄为	恣睢无忌	肆无忌惮	胡作非为	随心所欲	作恶多端	无恶不作	无所不为
置办	购买	购置	采办
置水之情	置水之清
罹难	遭灾
羊很狼贪	羊狠狼贪
美味	鲜味
羞与为伍	羞与哙伍
羞怯	羞涩
羞愧满面	脸红耳赤	面红耳赤
羽士	道士
羽觞	酒杯
翠绿	葱绿	青翠	青葱
翻戏	老千
翻来覆去	辗转不寐	辗转反侧
翻滚	翻腾
翻然悔悟	翻然悔改	翻然改进
老妪能解	通俗易懂
老有所养	老有所终
老气横秋	鹤发童颜	倚老卖老	老物可憎	反老还童	返老还童	老态龙钟	齿豁头童	老迈龙钟	蓬头历齿
老生	须生
考语	评语
耆儒硕老	耆德硕老
耐心	耐性	耐烦
耳环	耳饰
耳食之闻	道听涂说
耸人听闻	骇人听闻	危言耸听	混淆视听	混淆黑白	颠三倒四	颠倒黑白
聊复尔尔	聊复尔耳
聊天	谈天
联想	遐想	遥想
聘任	聘用
聪明反被聪明害	聪明反被聪明误
聪明才智	聪明智慧
聱牙戟口	聱牙诘屈	聱牙诘曲
肇始	肇端	起始
肉瘤	赘瘤
肋膜	胸膜
肥沃	肥美	肥饶
肥胖	肥壮
胆大妄为	轻举妄动	肆意妄为	肆无忌惮	胆大包天	胆大包身	浑身是胆	为所欲为	无所顾忌	跋扈自恣	骄横跋扈
胆大心小	胆大心细
胆子	胆量
背井离乡	嗷嗷待哺	涸辙之枯	涸辙之鲋	哀鸿遍野	啼饥号寒	饥啼号寒	饥寒交迫	创痍满目	民生凋敝	疮痍满目	百孔千疮	赤地千里	十室九空	卖儿鬻女	家破人亡	颠沛流离	倾家荡产	败尽家业	一贫如洗	债台高筑	别无长物	家徒四壁	民劣财尽	空空如也	软囊羞涩	贫无立锥
背信	背约
背后	背地	私下
胜负	胜败	输赢
胡匪	马贼
胡言乱语	课语讹言	信口开河	心直口快	脱口而出	言不及义	鬼话连篇	胡说乱道	胡说八道	有口无心	信口雌黄	妄下雌黄	口不择言	天花乱坠	一簧两舌	信口胡言	梦中说梦	井然有序	倒横直竖	横三竖四	语无伦次	颠三倒四	颠倒错乱	有条有理	条理清楚	言三语四	信口开合
胡须	髯毛
胪陈	详述
胯下之辱	胯下蒲伏
胶卷	菲林
能言善辩	舌粲莲花	喙长三尺	口若悬河	应对如流	应答如流	能言快语	能说会道	辩才无碍	高谈雄辩
脓包	饭桶
脚不沾地	脚不点地
脚印	萍踪	足迹
脚踏实地	足履实地	兢兢业业	好高鹜远	埋头苦干	按名责实	控名责实	实事求是	循名责实	顾名思义	下马看花	不务空名	捕风捉影	量力而行
脱缰之马	脱缰野马
脱落	零落
脸色	表情	心境	心情	情感	情绪	感情	激情	豪情
腊肠	香肠
腐化堕落	蜕化变质
腴膏	膏腴
腾云跨风	腾云驾雾
腾跃	腾踊	跳跃
腾飞	起飞	降落
膜拜	跪拜
自主	自立
自信	自傲	自大	自尊	自负	目空四海
自卑	自卑感	自卑过甚
自夸	自诩
自如	自若
自寻烦恼	自讨苦吃	自诒伊戚	自贻伊戚
自尽	自杀
自我作古	自我作故	自取灭亡	飞蛾扑火	飞蛾投火	飞蛾赴火	作法自毙	作茧自缚	玩火自焚	自作自受	自投罗网	自掘坟墓	自食其果	吐丝自缚
自暴自弃	妄自菲薄	自惭形秽	自愧不如	自轻自贱
自身难保	自顾不暇	泥船渡河	泥菩萨过江	一毫不染	一清二楚	一清二白	冰清玉洁	窗明几净	黑白分明	明哲保身	草人救火
自郐以下	自郐而下
臭不可当	臭不可闻	臭名远扬	一代风流	遗臭万年	人所不齿	声名狼藉	臭名昭着	身败名裂	名誉扫地	臭名昭著	威信扫地	丑声远播	斯文扫地
至亲好友	至亲骨肉	至爱亲朋歙漆阿胶	气味相投	刎颈交	生死之交	义结金兰	刎颈之交	患难之交	患难与共	同命鸳鸯	同甘共苦	安危与共	患难夫妻	休戚与共	分甘共苦	分甘同苦	同舟共济	有福同享，有难同当	风雨同舟
致歉	赔罪	道歉	告罪	陪罪
舆论	言论	谈吐	辞吐
舌人	译员
舍己为人	舍己救人	卖友求荣	损人利己	杀人越货	假公济私	营私舞弊	打家劫舍	江洋大盗	谋财害命	浑水摸鱼	趁火打劫	顺手牵羊
舞文弄墨	舞笔弄文
舞文弄法	舞文玩法
舞蹈	跳舞
舟子	船夫
航线	航路
船主	船长
船到桥门自会直	车到山前必有路	顺其自然
船厂	船坞
良母贤妻	贤妻良母
色彩	色调	颜色
色胆包天	色胆迷天
艳丽	鲜艳
艳如桃李，冷如冰霜	艳如桃李，冷若冰霜
节录	选录
节气	骨气
芒然自失	茫然自失
芒鞋	草鞋
芗泽	芳泽
芝兰玉树	谢庭兰玉
芬芳	芳香
花卉	花草
花园	花圃
花好月圆	鹊笑鸠舞
花街柳巷	花街柳市
花钱	费钱
花香鸟语	莺吟燕舞	莺歌燕舞	鸟语花香
芳华	青春
芽菜	豆芽
苍翠欲滴	葱翠欲滴
苍老	衰老	朽迈
苍茫	苍莽
苍蝇见血	见财起意	见钱眼开
苍髯如戟	须髯如戟
苛虐	荼毒	虐待
苦中作乐	强颜欢笑
苦口婆心	语重心长	微言大义	苦口相劝	言近旨远	不厌其烦	循循善诱	诲人不倦	谆谆告诫	谆谆教导	金针度人
苦命	薄命
苦涩	香甜
英姿	雄姿
英明	贤明
英雄仗义	豪侠好义	英气	豪气
范围	范畴	规模	领域
茫无头绪	茫无端绪	不得要领	不胜其烦	博士买驴	鸡零狗碎	转弯抹角	迂回曲折	不痛不痒	不知所为	不知所云	博而寡要	吞吞吐吐	茫然不解	语无伦次	雾里看花
茶余酒后	茶余饭后	茶余饭饱	酒余茶后
茶室	茶楼	茶肆	茶馆
茶话会	谈话会
茶饭不思	茶饭无心
草拟	起草
草木茂盛	长林丰草
草泽	草莽	草野
草率行事	轻举妄动	胡作非为
草行露宿	雨卧风餐	雨宿风餐	餐风露宿	跋山涉水	露餐风宿	风尘仆仆	栉风沐雨	披星戴月	露宿风餐	夜以继日	餐风宿雨	餐风宿露	餐风饮露	行色仓皇	行色匆匆	幕天席地	风餐露宿	寝苫枕块	筚路蓝缕	荜路蓝缕
荒僻	荒僻罕见
荒淫无度	荒淫无耻	穷奢极侈	骄奢淫逸	穷奢极欲	醉生梦死	骄奢淫佚	灯红酒绿	花天酒地	纸醉金迷
荡瑕涤秽	除污去垢
药剂师	配药师
药石之言	针砭之语
荷包	钱袋
莠民	败类	坏人
莫名其妙	莫明其妙	不可思议	岂有此理	摸头不着	摸门不着
莫逆交	金兰交
获利	赚钱	赢利
莼羹鲈脍	莼鲈之思
菲仪	菲敬
菲酌	薄酌
萍泊	萍浮
营建	营造
营生	谋生	糊口
落井下石	雪上加霜	幸灾乐祸	投井下石	闻过则喜
落款	题名
著作	著述
葵扇	蒲扇
蒙受	遭受
蒹葭倚玉	蒹葭玉树
蓬发	蓬头	蓬葆
蓬荜	蓬门
薄暮冥冥	薄暮蒙蒙
薄物细故	鸡毛蒜皮
薏苡之谤	薏苡明珠
藉卉	藉槁
藏之名山	藏诸名山	藏诸名山，传之其人
藏踪秘迹	藏踪蹑迹
虎头燕颔	虎头燕额
虎睨	鹰视
虎豹	豺狼
虎踞龙盘	龙盘虎踞
虔敬	虔诚
虚弱	衰弱	懦弱	柔弱	纤弱	荏弱	亏弱	单薄	微弱	脆弱	薄弱	软弱	强劲
虚心	谦善	谦虚	谦逊
虫篆之技	雕虫小技	神通广大	雕虫篆刻
虫鸣水沸	蜩螗沸羹	人声鼎沸	沸反盈天	沸沸扬扬	满城风雨
虬龙片甲	骐骥一毛
蚌病成珠	蚌病生珠
蚕食鲸吞	鲸吞虎据	鲸吞蚕食
蛀牙	龋齿
蛇矛	长枪
蛮烟瘴雨	蛮烟瘴雾
蛮触之争	蜗角之争
蝇头小利	蝇头微利
血统	血缘
血肉相连	血脉相连	骨肉相连
血虚	贫血
血雨腥风	血风肉雨
行列步队	队列
行刺	谋杀
行家	里手
行尸走肉	酒囊饭袋	行尸走骨
行踪	行迹
衔接	跟尾
街头	陌头
衣不完采	衣不重采	节衣缩食	陋巷箪瓢	黜衣缩食	穷困潦倒	粗衣淡饭	粗衣粝食	粗茶淡饭	箪食瓢饮
衣租食税	衣食税租
衣绣夜行	衣锦夜行
衣衫蓝缕	覆穿踵决	鹑衣百结
衣香髻影	衣香鬓影
表里山河	表里河山
表里相应	表里相济
表面功夫	表面文章
衰年	颓龄
衰微	陵夷
衰草如烟	衰草连天
衰颓	颓败
被褐怀玉	被褐怀珠
被迫	宁可	宁肯	宁愿
裁人	裁员
裁判员	评判员
裁夺	酌定
裁月镂云	镂云裁月
裂裳裹膝	裂裳裹足
装璜	装饰
装疯卖傻	装聋作哑	假痴假呆	卖乖弄俏
裕民足国	裕民足民
裸体	赤身
覆巢无完卵	覆巢破卵
见危授命	见危致命
见好就收	趁势落篷
见机	识趣
见猎心喜	跃跃欲动
见笑于人	贻笑大方	见笑大方
见色忘友	重色轻友
见闻广博	博览古今	博览群书	博闻强记	博洽多闻	博闻多识	博闻强志	博闻强识	博大精深	见多识广	博物多闻	博物洽闻	博古通今	博学多才	博学多闻	宏儒硕学	学富才高	才高八斗	满腹经纶	经天纬地	博文强识
观者如垛	观者如堵	观者成堵
视同陌路	视若路人
角楼	谯楼
解甲归田	解甲投戈	刀枪入库	故土难离	落叶归根	马放南山	退役还乡	按甲休兵	按甲寝兵
解雇	辞退
触目伤心	触目恸心
触类旁通	问牛知马	问羊知马	一隅三反	举一反三	融会贯通	闻一知十	知一万毕	豁然贯通
言不及辞	词不达意	词不逮意	辞不达意
言之不详	语焉不详
言之谆谆，听之藐藐	言者谆谆，听者藐藐
言听计从	回心转意	改变主张	翻然悔悟	脱胎换骨	伐毛换髓	夺胎换骨	伐毛洗髓	荡垢涤污
言归正传	闲话休说	闲话少说
言教	身教
言笑	说笑	谈笑
言行不一	靖言庸违	言行一致	坐言起行	不重人	以貌取人	表里如一	心口如一
言谈举止	音容笑貌
警愦觉聋	震耳发愦
计穷力尽	计穷力竭	黔驴技穷	黔驴之技	江淹才尽	江郎才尽	无计可施	束手无策	计无所出	走投无路	黔驴技尽	没计奈何	机关用尽	力不从心	力不胜任	力不能及	心余力绌	无能为力
认敌为友	认贼为子
讨价	还价
让开	闪开
让步	退让	妥协
让渡	转让
记住	记取	记着
记功	记过
记叙	记述
讲古论今	谈今说古
讹传	谣传
讹夺	错漏
论述	阐述	叙说	叙述
设宴	设席
证实	证明
评价	评估
评头品足	评头论足	说三道四	说长道短	品头评足	论长道短	品头论足	指手划脚	比手划脚	挤眉弄眼	指东划西	指东画西
评断	评议
评比	评选
识别	辨认
识文断字	识文谈字
诈财	骗财
词典	辞书
词华	词藻	词采
词条	词目
词章	词翰
诘问	追问
诛凶殄逆	诛暴讨逆
话中带刺	话里带刺
诞生	降生
详实	详确
诬害	诬陷
语妙天下	语妙绝伦
诱饵	钓饵
说长道短	说黄道黑	说黑道白	道长论短	大发议论	大放厥词	拉三扯四	拉拉扯扯	争长论短	交头接耳	众说纷纭	街谈巷议	议论纷纷	说三道四	说东道西
请帖	请柬
诽语	谗言
谁人	那个	阿谁
调剂	调度	调理	调节
调笑	谐谑
谄上抑下	谄上欺下
谋臣武将	谋臣猛将
谑浪笑傲	谑浪笑敖
谙习	谙熟
谠言嘉论	谠言直声
谢世	辞世	作古	去世	归天	死	逝世
谦和	谦恭
谦谢	逊谢
谬爱	错爱
谬采虚声	谬采虚誉
豁然	释然
豆乳	豆浆
豢养	饲养
豹隐	遁世
负荆请罪	面缚舆榇	兴师问罪	鸣鼓而攻	大张挞伐
负薪之忧	负薪之病
负险固守	负隅顽抗	困兽犹斗	狗急跳墙	禽困覆车	穷鼠啮狸	垂死挣扎	孤注一掷	破釜沉舟	铤而走险	济河焚州	背城一战	背城借一	背水一战
财务	财政
财殚力痡	财殚力竭	财竭力尽
财气	财运
财源	财路
财货	财贿
责难	非难
贤能	贤良	贤达
败事	败露
败兴而归	败兴而返
败法乱纪	违法乱纪
货品	货物	货色
质疑辨惑	质疑问难
贩卖	销售	发卖
贪婪	贪心	贪欲
贪杯	贪酒	贪吃	饕餮	贪嘴	贪馋	馋嘴
贪污舞弊	饮马投钱
贫病交加	贫病交迫
贬低	贬斥
贯串	贯穿	贯通
贯朽粟红	贯朽粟腐	贯朽粟陈
贱体	顽躯
贵人多忘	贵人多忘事
贵壮贱弱	贵壮贱老	贵少贱老
费解	隐晦
贺喜	道喜
贼头贼脑	贼头鼠脑	贼眉贼眼	贼眉鼠眼
资历	资格
赋税	钱粮
赍志而殁	赍志而没
赏光	赏脸
赏给	赐给
赛马	跑马
赠予	赠送
赤口烧城	赤舌烧城
赤手上阵	赤膊上阵	轻装上阵
赤绳系足	赤绳绾足
赤诚相见	吐肝露胆	吐胆倾心
赦免	赦宥
走走	逛逛
赶上	遇上
起首	首先
趁便	顺便
趁势	顺势
超以象外	超然物外	超然象外
超凡	超常	超等	超级
超尘出世	闲云野鹤	飘飘欲仙1	自得其乐1	怡然自得	逍遥自在	悠哉游哉	悠闲自得
超尘出俗	超尘拔俗	卓荦不群	超凡入圣	超绝群伦	出类拔萃	超群绝伦	名列前茅	首屈一指	鹤立鸡群	超群出众	超群拔类	超群拔萃	超轶绝尘	秀出班行	卓乎不群	卓尔不群	天之骄子	庸中佼佼	数一数二
超然自得	超然自逸	逸然自得
超群	轶群
超群脱俗	逸群绝俗
超越	超过	跨越	逾越
超额	逾额
越人肥瘠	越瘦秦肥
越狱	逃狱
趋势	趋向
跌宕	跌宕放诞	跌荡	跌荡放诞
跌宕不羁	跌宕放言	跌荡不羁
跑江湖	跑码头
跟着	随着
跨凤乘鸾	跨凤乘龙
跨鹤西归	驾返瑶池
路子	途径
路过	途经
路途	道路
跳出火炕	逃出生天
跳班	跳级
践踏	蹂躏
跺脚	顿脚
踉跄	蹒跚
踌躇满志	趾高气扬	志得意满	春风得意	春风满面	笑容满面	慷慨激昂	扬眉吐气	眉飞色舞	心潮澎湃	意气风发	热血沸腾	百感交集	斗志昂扬	英姿飒爽
踥蹀	蹀躞
踩踏辚轹	蹂躏踹踏
蹇视高步	一往无前	勇往直前	所向披靡	所向无敌	无所畏惧	无私无畏	乘风破浪	披荆斩棘	势不可挡	势在必行	大势所趋	奋勇向前	裹足不前	畏缩不前	前仆后继	前赴后继
蹉跎岁月	蹉跎时日	蹉跎自误
蹑手蹑脚	轻手轻脚	轻手软脚	鬼鬼祟祟	偷偷摸摸	鬼头鬼脑
身体	身材	身段
身故	身死
躲债	避债
车怠马烦	车殆马烦
车费	车资
软玉温香	软香温玉
轰隆	霹雳	霹雷
轻口薄舌	轻口轻舌	轻嘴薄舌
轻歌曼舞	鸾歌凤舞
轻活	重活
轻车减从	轻车简从
输送	运送
辛劳	辛勤	辛苦
辛酸	酸楚
辟谣	造谣
边境	边疆	边陲
边沿	边缘	边际
边远	遥远	悠远	辽远	迢遥
辽东白豕	辽东豕
迁徙	迁移
迅雷不及掩耳	追风逐电	风驰电掣	出其不意	流星赶月	电炮火石
过头	过甚
过屠大嚼	过屠门而大嚼
过时	过期	逾期
迎风	顶风
迎风招展	迎风飘扬	随风飘扬
运用之妙，存乎一心	运用之妙，存于一心
运行	运转
近悦远来	迩安远至
近来	迩来
近邻	隔壁	隔邻
进退无路	进退无门
远亲不如近邻	远水不救近火
远足	郊游	远程	长途
违反	违背
违心之言	违心之论
迫良为娼	逼良为娼
迫近	逼近	亲近	切近	迫临	亲切	激情	热忱	亲密	贴近
迷而不反	迷而不返
迷魂夺魄	迷魂淫魄
追名逐利	餐腥啄腐
追忆	追想
追本穷源	饮水思源
追赶	追逐
退位	逊位
退兵	退军
送命	送死
适应	顺应
适逢其会	适逢其时
逃脱	逃走
逃难	避祸
选派	遴派
透彻	透辟
透明	通明
透风	通风
逗弄	逗引
通信	通讯
逞强	逞能	好胜
速度	速率
逢山开路	逢山开道
逸事	逸闻
逾墙窥隙	逾墙钻穴	逾墙钻隙
遁藏	隐匿	藏匿	埋没	湮没	潜伏	潜在	窜伏	荫蔽	隐蔽	隐藏	匿伏	埋伏	暗藏	潜藏	躲藏
遁词	饰词	托词	藉词
遐龄	高寿
遗簪坠履	遗簪坠屦
遗闻轶事	遗闻逸事
遥不可及	高不可攀	仰之弥高	高山仰止	高插云霄	高不可及	高不可登
遭逢	遭遇
遮人耳目	隐姓埋名
遵养时晦	遵时养晦	东张西望	东瞧西望	举棋不定	趑趄不前	首鼠两端
避世金门	避世金马
避其锐气，击其惰归	避实击虚
避忌	避讳
避祸就福	避祸求福
那儿	那处	那边	那里
邪术	魔法	邪不压正	魔高一尺，道高一丈
郁郁不乐	闷闷不乐	忽忽不乐	怅然若失	惘然若失	若有所失
酒徒	醉翁	酒鬼
酣歌恒舞	酣歌醉舞
采薪之忧	采薪之疾
重任	重担	重任在身	钦差大臣
野无遗才	野无遗贤
金城汤池	铜墙铁壁	固若金汤	坚如磐石	安如泰山	安如磐石	铁壁铜墙	高城深池
金屋藏娇	金屋贮娇收视反听	真心实意	鞠躬尽瘁	一心一计	一门心思	专心致志	全神贯注	目不转睛	聚精会神
金浆玉液	金浆玉醴
金灿灿	黄灿灿
金貂取酒	金貂换酒
金钱万能	钱可通神
釜中之鱼	釜中游鱼	风中之烛	风中残烛	风烛残年	行将就木	枯木朽株	气息奄奄
鉴貌辨色	察颜观色	观颜察色	聆音察理	察言观色
钩元提要	钩玄提要
钱庄	银号
钻穴逾垣	钻穴逾墙	钻穴逾隙
铁丝网	铁蒺藜
铁案如山	铁证如山	凿凿可据	凿凿有据	言之凿凿	千真万确	无庸置疑	确凿不移	不移至理	天经地义	理当如此	理所当然	一成不变	江河行地	义不容辞	在所不辞	当仁不让	责无旁贷	责有所归	责有攸归	义无反顾	见义勇为
铁画银钩	铁笔银钩
铜头铁臂	铜头铁额
铭刻	铭记	谨记
银白	雪白	蜡白
铸造	锻造
锄奸	除奸
锦囊妙计	袖中神算
锦绣心肠	锦绣肝肠
镇痛剂	麻醉剂
镜里观花	镜里采花
长命	长寿	龟龄
长斋礼佛	长斋绣佛
长眠	长逝
长舌之妇	长舌妇
长辔远御	长辔远驭
长风万里	鹘程万里
门可罗雀	门堪罗雀	门庭冷落
门客	食客
门无杂客	门无杂宾
门生故吏	门生故旧
闪动	闪灼	闪烁	闪耀
闪电战	霹雳战
闭户读书	闭门读书
闭门却扫	闭门谢客	韬光养晦	韬光晦迹	杜门不出	闭门不出	韬匮藏珠	闭关却扫	闭关自守
问寒问暖	问这问那	问长问短	偷寒送暖
闲聊	闲谈
闺范	阃范
闻一知二	闻一知十
闻风而动	闻风而逃	闻风远扬	闻风而起	雷厉风行	大张旗鼓	排山倒海	雷霆万钧	扬铃打鼓	叱咤风云	声势浩大	死灰复燃	气势磅礡	气势磅	轰轰烈烈	重振旗鼓	气势磅礴	气壮山河
阅兵	检阅
阔论高谈	高睨大谈	高谈阔论	侃侃而谈	夸夸其谈	高谈大论	娓娓动听	娓娓而谈	绘声绘色	谈天说地	谈空说有	言三语四	说三道四	说东道西	沉默寡言	口若悬河	能言善辩
防地	防线
阳世	阳间
阳关三迭	骊歌高唱
阴郁	阴霾	暗中	漆黑	黑暗	乌黑	黝黑	阴森森	黑沉沉
阿公	阿婆	阿家	阿翁
陈师鞠旅	鞠旅陈师
陋规	黑钱
降尊临卑	降贵纡尊	降尊纡贵
除旧布新	革故鼎新	推陈布新	大破大立
险路	险途
陪侍	随侍
隆运	鸿运
随俗	顺俗
随俗沉浮	随俗浮沉
隐忍不发	隐忍不言
隐私	隐衷
隐约	隐隐
隔开	隔阂
难听	逆耳	刺耳
雁足传书	鱼雁不绝
雅人深致	雅人清致
雅致	高雅	文雅
雍容大度	雍容尔雅	富丽堂皇	琼楼玉宇	金壁辉煌	雕栏玉砌	雕梁画栋	美仑美奂	金碧辉煌	雍容华贵
雕落	雕零
雪中送炭	雪里送炭
雪恨	雪耻
雪泥鸿爪	飞鸿印雪	飞鸿踏雪	飞鸿雪爪
零打碎敲	零敲碎打
霜露之思	霜露之悲	霜露之感
非亲非故	毫不相关	无关
非同一般	非同寻常	非同小可
面如土色	面无人色	面色如土
面目一新	面目全非
面貌	风姿	风度	风貌
鞍马劳倦	鞍马劳顿
鞠躬尽力	鞠躬尽瘁	死而后已	毙而后已	废寝忘食	摩顶放踵	枵腹从公	凿壁偷光	发愤忘食	囊虫映雪	穿壁引光	疾病缠身	积劳成疾	身心交瘁	心力交瘁	精疲力竭	身心交病
顶嘴	顶撞
顺利	顺遂
顺势而行	顺时而动
顺天从人	顺天应人
顺我者昌，逆我者亡	顺昌逆亡
顺手人情	顺水人情	顺路	顺道
顾前不顾后	顾头不顾尾
顾左右而言他	顾而言他
预付	预支
预告	预报
预定	预约
预感	预见
领袖	首脑
颊上三毛	颊上三毫
频仍	频繁
颓丧	颓废
颖悟	颖慧
颠来播去	颠来簸去
风云	风波	风浪
风云人物	风流人物	风流才子
风从虎，云从龙	风虎云龙
风仪	风味	风姿潇洒	风度翩翩	风范	风采	风韵	风华正茂	风流倜傥	风流潇洒
风俗人情	风土人情
风号浪吼	风高浪急
风和日丽	风和日暄	风和日暖
风姿绰约	风韵犹存
风止	风静
风流	风骚	风流佳话	风流韵事
风清月明	风清月朗
风筝	鹞子
风行草从	风行草偃
风靡云涌	风靡云蒸
风餐露宿	餐风沐雨
风马不接	风马牛不相及	风马牛不相干	驴唇不对马嘴	文不对题	离题万里	答非所问	前言不搭后语	胡说八道	驴唇马嘴
飘动	飞舞
飘茵落溷	飘茵随溷
飙举电举	飙举电至	飙发电举	飙发电至
飞沙走石	飞砂走石
飞鹰走犬	飞鹰走狗
食古不化	食而不化
食品	食物
餍饫	饱食
饔飧不济	饔飧不继	饥荒	饥馑
饭店	饭铺	饭馆
饱暖思淫欲	饱暖生淫欲
首级	首领
香喷喷	香馥馥
香象渡河	香象绝流
騃女痴儿	騃女痴男
马上功成	马上得天下
马到成功	旗开得胜
马工枚速	马迟枚疾
驯良	驯顺
驴鸣犬吠	驴鸣狗吠
驷不及舌	驷马难追
驷马高盖	驷马高车
驾鹤成仙	驾鹤西游
驿使梅花	驿寄梅花
骂天咒地	骂天扯地
骑牛觅牛	骑马找马	骑驴找驴	骑驴觅驴
骨肉	骨血
骨软筋酥	骨软肉酥
髀肉复生	髀里肉生
高下任心	高下在心
高不凑低不就	高不成低不就	高低不就
高作	高招	妙招
高堂大厦	高楼大厦
高情远意	高情远致	高情远韵
高才捷足	高材疾足
高文典册	高文典策
高步云衢	高步通衢
高风亮节	高风峻节
鬼域	黄泉
鬼头滑脑	鬼头鬼脑	鬼鬼祟祟	鬼摸脑壳	鬼迷心窍
鬼怪	鬼魅	鬼神不测	鬼神莫测
鱼溃鸟散	鱼溃鸟离	溃不成军
鱼烂取亡	鱼烂土崩	鱼烂而亡	国破家亡
鱼跃鸢飞	鸡飞狗跳	鸢飞鱼跃	鸡飞狗叫	鸡飞狗走	鸡犬不宁	匕鬯不惊	秋毫无犯	纪律严明
鱼龙曼羡	鱼龙曼衍
鲜车健马	鲜车怒马
鸡皮鹤发	鸡肤鹤发
鸡鸣候旦	鸡鸣戒旦
鸡鸣犬吠	鸡鸣狗吠
鸦飞雀乱	鸦飞鹊乱
鸨母	龟婆
鸿图	鸿猷	鹏图
鸿毛泰山	鸿毛泰岱
鹑居鷇食	鹑居鷇饮
鹤寿	龟年
鹰瞵鹗视	鹰觑鹘望
鹰视狼步	鹰视虎步
鹿死不择荫	鹿死不择音
黄口孺子	黄口小儿	少不更事	少不经事	乳臭未干	年幼无知	口尚乳臭	毛羽未丰	羽毛未丰	涉世不深
黑色	玄色
黔首	黔黎
默认	默许
黯然伤神	黯然泪下	黯然神伤
鼎峙	鼎立
鼓唇弄舌	鼓唇摇舌
齿如齐贝	齿若编贝
龙盘凤逸	龙蟠凤逸
乐不可支	兴奋	兴高采烈	喜上眉梢	喜不自胜	喜形于色	喜悦	喜眉笑眼	喜笑颜开	喜逐颜开	嘻嘻哈哈	嬉皮笑脸	康乐	开心	心花怒放	快乐	愉快	手舞足蹈	春风得意	欢乐	欢喜	欢天喜地	欢娱	欢快	欢悦	欢愉	欢欣	欢欣鼓舞	欢畅	欢腾	欢跃	欣喜若狂	满面春风	眉开眼笑	眉飞色舞	笑容可掬	笑逐颜开	载歌载舞	雀跃	高兴	?喜气洋洋
丑态百出	仰首伸眉	出乖弄丑	出乖露丑	吐气扬眉	如醉如痴	嬉皮笑脸	得意忘形	得意忘形	得意扬扬	得意洋洋	忘乎所以	忘其所以	意气扬扬	意气洋洋	扬扬得意	挤眉弄眼	摆尾摇头	摇头摆尾	摇头晃脑	沾沾自喜	沾沾自喜	沾沾自满	洋洋得意	洋洋自得	自得其乐2	自我陶醉	自鸣得意	自鸣得意	趾高气扬	飘飘欲仙2
一弹指顷	一日三秋	一日不见，如隔三秋	一时三刻	一时半刻	一时半晌	一时半霎	一朝一夕	乌飞兔走	仓卒之际	似水流年	光阴似箭	寸阴若岁	岁月难熬	度日如年	弹指之间	斯须	日月如梭	昙花一现	白驹过隙	瞬息	稍纵即逝	翘足而待	转眼	转眼之间	转瞬	转瞬之间	霎时	霎那之间	顷刻	须臾	驹窗电逝
举棋不定	优柔寡断	可怕	害怕	当断不断	心不在焉	心惊胆颤	心猿意马	心神不定	心神恍惚	忧惧	怕惧	怦然心动	怯弱	怯怯乔乔	怯生生	恐忧	恐怖	恐惧	惊怕	惧怕	投鼠忌器	有所顾忌	犹豫不决	畏惧	畏首畏尾	瞻前顾后	胆大	胆寒	胆小	胆小如鼠	胆小怕事	胆怯
一仍旧贯	与世无争	刻舟求剑	固步自封	墨守成规	墨守成规	守株待兔	安份守己	安分	安分守己	安分守纪	安常习故	安常守故	循分	循序渐进	循规蹈矩	循规蹈矩	抱残守缺	按部就班	由浅入深	登高自卑	绳趋尺步	行远自迩	规行矩步	践规踏矩	遵纪守法	随遇而安
七窍生烟	令人发指	勃然大怒	大发雷霆	怒不可遏	怒发冲冠	怒形于色	怒气冲冲	怒气冲天	怒目切齿	怨气冲天	恼羞成怒	愤然作色	拊膺切齿	暴跳如雷	牢骚满腹	老羞成怒	雷霆大发
云谲波诡	云谲风诡	再接再厉	出尔反尔	千变万化	反复不定	反复无常	变化多端	变化无常	变化莫测	变幻不测	变幻无常	变幻莫测	夜长梦多	朝三暮四	朝令夕改	朝令暮改	朝四暮三	朝梁暮晋	朝梁暮陈	朝秦暮楚	生死与共	白云苍狗	瞬息万变	翻云覆雨	背信弃义	言而无信	阪上走丸	风云万变	风云变幻	风云突变	风谲云诡
一马当先	不敢后人	不甘后人	不甘示弱	不甘落后	不甘雌伏	争先	争先恐后	争分夺秒	你追我赶	先下手为强	先发制人	先声后实	先声夺人	先手	分秒必争	力争上游	奋勇争先	奋勇当先	恐后争先	抢先	遥遥领先
一意孤行	一成不变	始终不渝	屡教不改	怙恶不悛	恶性难改	执而不化	执迷不悟	执迷不悟	死不悔改	死不改悔	死心塌地	死心塌地	死心塌地	洞烛奸邪	累教不改	罪大恶极	脂膏不润	脂膏莫润	至死不变	至死不悟	至死不渝	顽固不化	顽梗不化
一寸丹心	一片丹心	为国捐躯	之死靡它	以身殉职	以身许国	克尽厥职	克尽职守	尽忠报国	忠	忠于职守	忠心耿耿	忠心赤胆	忠肝义胆	忠贞不二	忠贞不渝	披肝沥胆	捐躯报国	有死无二	毋忝厥职	矢忠不二	精忠报国	肝胆相照	誓死不二	誓死不贰	赤子之心	赤胆忠心	赤血丹心	鞠躬尽瘁
不以为然	不屑一顾	不敢苟同	五体投地	以理服人	何乐不为	口服心服	嗤之以鼻	奉为圭臬	奉为楷模	奉若神明	姜太公钓鱼，愿者上钩	心悦口服	心悦诚服	心服口服	心甘情愿	拜倒辕门	死心塌地	毕恭毕敬	毫不勉强	满不在乎	甘拜下风	等闲视之	肃然生敬	肃然起敬	视如敝屣	言之有理	顶礼膜拜
一德一心	一心一德	万众一心	万全之策	万全之计	人多势众	众人拾柴火焰高	众志成城	众擎易举	兵多将广	单枪匹马	合力攻敌	同心协力	同心同德	戮力一心	戮力同心	计出万全	锦囊妙计	齐心协力
任其自流	任其自然	任天由命	听之任之	听之任之	听任	听其自然	听天由命	大势所趋	放任	放任自流	放任自流	纵容	自然而然	自生自灭	鼎力	鼎力大举
万籁俱寂	万籁无声	万马齐喑	不存不济	不死不活	不生不死	不生不灭	半死不活	委靡不振	寂然无声	少气无力	死气	死气沉沉	筋疲力尽	老气	萎靡不振	阒寂无声	鸦雀无闻	鸦默雀静
不毛之地	不牧之地	不食之地	与世隔绝	世外桃源	人迹罕至	寸草不生	无人之境	杜门却扫	杜门谢客	渺无人烟	疏落	穷乡僻壤	穷山垩水	穷山恶水	荒凉	荒山野岭	荒无人烟	荒芜	萧疏	赤地千里
专横	嚣张	大肆1	放肆	放胆	猖狂	猖獗	疯狂	豪恣	跋扈	
大举	大力	大肆2
